index,Date,Season,home,visitor,FT,hgoal,vgoal,division,tier,totgoal,goaldif,result,mngr,lfc_goals,at_anf
0,1893-09-02,1893.0,Middlesbrough Ironopolis,Liverpool,0-2,0,2,2,2,2,-2,A,"McKenna, John",2,Away
1,1893-09-09,1893.0,Liverpool,Lincoln City,4-0,4,0,2,2,4,4,H,"McKenna, John",4,Anfield
2,1893-09-16,1893.0,Manchester City,Liverpool,0-1,0,1,2,2,1,-1,A,"McKenna, John",1,Away
3,1893-09-23,1893.0,Liverpool,Birmingham City,3-1,3,1,2,2,4,2,H,"McKenna, John",3,Anfield
4,1893-09-30,1893.0,Notts County,Liverpool,1-1,1,1,2,2,2,0,D,"McKenna, John",1,Away
5,1893-10-07,1893.0,Liverpool,Middlesbrough Ironopolis,6-0,6,0,2,2,6,6,H,"McKenna, John",6,Anfield
6,1893-10-14,1893.0,Birmingham City,Liverpool,3-4,3,4,2,2,7,-1,A,"McKenna, John",4,Away
7,1893-10-21,1893.0,Burton Swifts,Liverpool,1-1,1,1,2,2,2,0,D,"McKenna, John",1,Away
8,1893-10-28,1893.0,Arsenal,Liverpool,0-5,0,5,2,2,5,-5,A,"McKenna, John",5,Away
9,1893-11-04,1893.0,Liverpool,Newcastle United,5-1,5,1,2,2,6,4,H,"McKenna, John",5,Anfield
10,1893-11-11,1893.0,Walsall,Liverpool,1-1,1,1,2,2,2,0,D,"McKenna, John",1,Away
11,1893-11-18,1893.0,Liverpool,Notts County,2-1,2,1,2,2,3,1,H,"McKenna, John",2,Anfield
12,1893-11-25,1893.0,Newcastle United,Liverpool,0-0,0,0,2,2,0,0,D,"McKenna, John",0,Away
13,1893-12-02,1893.0,Liverpool,Manchester City,3-0,3,0,2,2,3,3,H,"McKenna, John",3,Anfield
14,1893-12-09,1893.0,Liverpool,Walsall,3-0,3,0,2,2,3,3,H,"McKenna, John",3,Anfield
15,1893-12-28,1893.0,Crewe Alexandra,Liverpool,0-5,0,5,2,2,5,-5,A,"McKenna, John",5,Away
16,1893-12-30,1893.0,Liverpool,Grimsby Town,2-0,2,0,2,2,2,2,H,"McKenna, John",2,Anfield
17,1894-01-01,1893.0,Liverpool,Arsenal,2-0,2,0,2,2,2,2,H,"McKenna, John",2,Anfield
18,1894-01-06,1893.0,Rotherham Town,Liverpool,1-4,1,4,2,2,5,-3,A,"McKenna, John",4,Away
19,1894-01-13,1893.0,Liverpool,Rotherham Town,5-1,5,1,2,2,6,4,H,"McKenna, John",5,Anfield
20,1894-02-03,1893.0,Liverpool,Northwich Victoria,4-0,4,0,2,2,4,4,H,"McKenna, John",4,Anfield
21,1894-03-03,1893.0,Liverpool,Burton Swifts,3-1,3,1,2,2,4,2,H,"McKenna, John",3,Anfield
22,1894-03-17,1893.0,Lincoln City,Liverpool,1-1,1,1,2,2,2,0,D,"McKenna, John",1,Away
23,1894-03-24,1893.0,Liverpool,Crewe Alexandra,2-0,2,0,2,2,2,2,H,"McKenna, John",2,Anfield
24,1894-03-28,1893.0,Northwich Victoria,Liverpool,2-3,2,3,2,2,5,-1,A,"McKenna, John",3,Away
25,1894-03-31,1893.0,Grimsby Town,Liverpool,0-1,0,1,2,2,1,-1,A,"McKenna, John",1,Away
26,1894-04-07,1893.0,Port Vale,Liverpool,2-2,2,2,2,2,4,0,D,"McKenna, John",2,Away
27,1894-04-14,1893.0,Liverpool,Port Vale,2-1,2,1,2,2,3,1,H,"McKenna, John",2,Anfield
28,1894-09-01,1894.0,Blackburn Rovers,Liverpool,1-1,1,1,1,1,2,0,D,"McKenna, John",1,Away
29,1894-09-03,1894.0,Burnley,Liverpool,3-3,3,3,1,1,6,0,D,"McKenna, John",3,Away
30,1894-09-08,1894.0,Liverpool,Aston Villa,1-2,1,2,1,1,3,-1,A,"McKenna, John",1,Anfield
31,1894-09-13,1894.0,Liverpool,Bolton Wanderers,1-2,1,2,1,1,3,-1,A,"McKenna, John",1,Anfield
32,1894-09-15,1894.0,West Bromwich Albion,Liverpool,5-0,5,0,1,1,5,5,H,"McKenna, John",0,Away
33,1894-09-22,1894.0,Liverpool,Blackburn Rovers,2-2,2,2,1,1,4,0,D,"McKenna, John",2,Anfield
34,1894-09-29,1894.0,Wolverhampton Wanderers,Liverpool,3-1,3,1,1,1,4,2,H,"McKenna, John",1,Away
35,1894-10-06,1894.0,Liverpool,Sheffield United,2-2,2,2,1,1,4,0,D,"McKenna, John",2,Anfield
36,1894-10-13,1894.0,Everton,Liverpool,3-0,3,0,1,1,3,3,H,"McKenna, John",0,Away
37,1894-10-20,1894.0,Liverpool,Stoke City,2-0,2,0,1,1,2,2,H,"McKenna, John",2,Anfield
38,1894-10-27,1894.0,Aston Villa,Liverpool,5-0,5,0,1,1,5,5,H,"McKenna, John",0,Away
39,1894-11-03,1894.0,Liverpool,Burnley,0-3,0,3,1,1,3,-3,A,"McKenna, John",0,Anfield
40,1894-11-10,1894.0,Stoke City,Liverpool,3-1,3,1,1,1,4,2,H,"McKenna, John",1,Away
41,1894-11-17,1894.0,Liverpool,Everton,2-2,2,2,1,1,4,0,D,"McKenna, John",2,Anfield
42,1894-11-24,1894.0,Sunderland,Liverpool,3-2,3,2,1,1,5,1,H,"McKenna, John",2,Away
43,1894-12-01,1894.0,Liverpool,Wolverhampton Wanderers,3-3,3,3,1,1,6,0,D,"McKenna, John",3,Anfield
44,1894-12-08,1894.0,Sheffield United,Liverpool,2-2,2,2,1,1,4,0,D,"McKenna, John",2,Away
45,1894-12-15,1894.0,Liverpool,Birmingham City,3-1,3,1,1,1,4,2,H,"McKenna, John",3,Anfield
46,1894-12-25,1894.0,Bolton Wanderers,Liverpool,1-0,1,0,1,1,1,1,H,"McKenna, John",0,Away
47,1894-12-29,1894.0,Birmingham City,Liverpool,3-0,3,0,1,1,3,3,H,"McKenna, John",0,Away
48,1895-01-01,1894.0,Liverpool,West Bromwich Albion,4-0,4,0,1,1,4,4,H,"McKenna, John",4,Anfield
49,1895-01-05,1894.0,Sheffield Wednesday,Liverpool,5-0,5,0,1,1,5,5,H,"McKenna, John",0,Away
50,1895-01-09,1894.0,Derby County,Liverpool,0-1,0,1,1,1,1,-1,A,"McKenna, John",1,Away
51,1895-01-12,1894.0,Liverpool,Nottingham Forest,5-0,5,0,1,1,5,5,H,"McKenna, John",5,Anfield
52,1895-03-02,1894.0,Liverpool,Derby County,5-1,5,1,1,1,6,4,H,"McKenna, John",5,Anfield
53,1895-03-25,1894.0,Liverpool,Sunderland,2-3,2,3,1,1,5,-1,A,"McKenna, John",2,Anfield
54,1895-03-30,1894.0,Liverpool,Sheffield Wednesday,4-2,4,2,1,1,6,2,H,"McKenna, John",4,Anfield
55,1895-04-06,1894.0,Nottingham Forest,Liverpool,3-0,3,0,1,1,3,3,H,"McKenna, John",0,Away
56,1895-04-12,1894.0,Preston North End,Liverpool,2-2,2,2,1,1,4,0,D,"McKenna, John",2,Away
57,1895-04-20,1894.0,Liverpool,Preston North End,2-5,2,5,1,1,7,-3,A,"McKenna, John",2,Anfield
58,1895-09-07,1895.0,Notts County,Liverpool,2-3,2,3,2,2,5,-1,A,"McKenna, John",3,Away
59,1895-09-14,1895.0,Liverpool,Newcastle United,5-1,5,1,2,2,6,4,H,"McKenna, John",5,Anfield
60,1895-09-21,1895.0,Loughborough,Liverpool,2-4,2,4,2,2,6,-2,A,"McKenna, John",4,Away
61,1895-09-28,1895.0,Liverpool,Port Vale,5-1,5,1,2,2,6,4,H,"McKenna, John",5,Anfield
62,1895-09-30,1895.0,Liverpool,Burton Wanderers,4-1,4,1,2,2,5,3,H,"McKenna, John",4,Anfield
63,1895-10-05,1895.0,Newcastle United,Liverpool,1-0,1,0,2,2,1,1,H,"McKenna, John",0,Away
64,1895-10-07,1895.0,Liverpool,Crewe Alexandra,6-1,6,1,2,2,7,5,H,"McKenna, John",6,Anfield
65,1895-10-12,1895.0,Liverpool,Manchester United,7-1,7,1,2,2,8,6,H,"McKenna, John",7,Anfield
66,1895-10-19,1895.0,Grimsby Town,Liverpool,1-0,1,0,2,2,1,1,H,"McKenna, John",0,Away
67,1895-10-21,1895.0,Port Vale,Liverpool,5-4,5,4,2,2,9,1,H,"McKenna, John",4,Away
68,1895-10-26,1895.0,Liverpool,Notts County,3-0,3,0,2,2,3,3,H,"McKenna, John",3,Anfield
69,1895-11-02,1895.0,Manchester United,Liverpool,5-2,5,2,2,2,7,3,H,"McKenna, John",2,Away
70,1895-11-09,1895.0,Liverpool,Leicester City,3-1,3,1,2,2,4,2,H,"McKenna, John",3,Anfield
71,1895-11-16,1895.0,Arsenal,Liverpool,0-2,0,2,2,2,2,-2,A,"McKenna, John",2,Away
72,1895-11-23,1895.0,Liverpool,Darwen,0-0,0,0,2,2,0,0,D,"McKenna, John",0,Anfield
73,1895-11-30,1895.0,Leicester City,Liverpool,2-0,2,0,2,2,2,2,H,"McKenna, John",0,Away
74,1895-12-07,1895.0,Liverpool,Loughborough,1-0,1,0,2,2,1,1,H,"McKenna, John",1,Anfield
75,1895-12-14,1895.0,Darwen,Liverpool,0-4,0,4,2,2,4,-4,A,"McKenna, John",4,Away
76,1895-12-21,1895.0,Lincoln City,Liverpool,0-1,0,1,2,2,1,-1,A,"McKenna, John",1,Away
77,1896-01-01,1895.0,Liverpool,Manchester City,3-1,3,1,2,2,4,2,H,"McKenna, John",3,Anfield
78,1896-01-04,1895.0,Rotherham Town,Liverpool,0-5,0,5,2,2,5,-5,A,"McKenna, John",5,Away
79,1896-01-11,1895.0,Liverpool,Arsenal,3-0,3,0,2,2,3,3,H,"McKenna, John",3,Anfield
80,1896-01-25,1895.0,Liverpool,Lincoln City,6-1,6,1,2,2,7,5,H,"McKenna, John",6,Anfield
81,1896-02-18,1895.0,Liverpool,Rotherham Town,10-1,10,1,2,2,11,9,H,"McKenna, John",10,Anfield
82,1896-02-22,1895.0,Liverpool,Grimsby Town,3-1,3,1,2,2,4,2,H,"McKenna, John",3,Anfield
83,1896-02-29,1895.0,Burton Swifts,Liverpool,0-7,0,7,2,2,7,-7,A,"McKenna, John",7,Away
84,1896-03-07,1895.0,Burton Wanderers,Liverpool,2-1,2,1,2,2,3,1,H,"McKenna, John",1,Away
85,1896-03-21,1895.0,Liverpool,Burton Swifts,6-1,6,1,2,2,7,5,H,"McKenna, John",6,Anfield
86,1896-03-28,1895.0,Crewe Alexandra,Liverpool,0-7,0,7,2,2,7,-7,A,"McKenna, John",7,Away
87,1896-04-03,1895.0,Manchester City,Liverpool,1-1,1,1,2,2,2,0,D,"McKenna, John",1,Away
88,1896-09-01,1896.0,Sheffield Wednesday,Liverpool,1-2,1,2,1,1,3,-1,A,"Watson, Tom",2,Away
89,1896-09-05,1896.0,Blackburn Rovers,Liverpool,1-0,1,0,1,1,1,1,H,"Watson, Tom",0,Away
90,1896-09-07,1896.0,Liverpool,Bolton Wanderers,0-2,0,2,1,1,2,-2,A,"Watson, Tom",0,Anfield
91,1896-09-12,1896.0,Liverpool,Derby County,2-0,2,0,1,1,2,2,H,"Watson, Tom",2,Anfield
92,1896-09-19,1896.0,Bury,Liverpool,1-2,1,2,1,1,3,-1,A,"Watson, Tom",2,Away
93,1896-09-26,1896.0,Liverpool,West Bromwich Albion,0-0,0,0,1,1,0,0,D,"Watson, Tom",0,Anfield
94,1896-10-03,1896.0,Everton,Liverpool,2-1,2,1,1,1,3,1,H,"Watson, Tom",1,Away
95,1896-10-10,1896.0,Liverpool,Nottingham Forest,3-0,3,0,1,1,3,3,H,"Watson, Tom",3,Anfield
96,1896-10-17,1896.0,Sunderland,Liverpool,4-3,4,3,1,1,7,1,H,"Watson, Tom",3,Away
97,1896-10-19,1896.0,Sheffield United,Liverpool,1-1,1,1,1,1,2,0,D,"Watson, Tom",1,Away
98,1896-10-24,1896.0,Liverpool,Blackburn Rovers,4-0,4,0,1,1,4,4,H,"Watson, Tom",4,Anfield
99,1896-10-31,1896.0,West Bromwich Albion,Liverpool,0-1,0,1,1,1,1,-1,A,"Watson, Tom",1,Away
100,1896-11-07,1896.0,Liverpool,Sunderland,3-0,3,0,1,1,3,3,H,"Watson, Tom",3,Anfield
101,1896-11-14,1896.0,Preston North End,Liverpool,1-1,1,1,1,1,2,0,D,"Watson, Tom",1,Away
102,1896-11-21,1896.0,Liverpool,Everton,0-0,0,0,1,1,0,0,D,"Watson, Tom",0,Anfield
103,1896-11-28,1896.0,Nottingham Forest,Liverpool,2-0,2,0,1,1,2,2,H,"Watson, Tom",0,Away
104,1896-12-12,1896.0,Liverpool,Bury,3-1,3,1,1,1,4,2,H,"Watson, Tom",3,Anfield
105,1896-12-19,1896.0,Derby County,Liverpool,3-2,3,2,1,1,5,1,H,"Watson, Tom",2,Away
106,1896-12-25,1896.0,Liverpool,Aston Villa,3-3,3,3,1,1,6,0,D,"Watson, Tom",3,Anfield
107,1896-12-26,1896.0,Burnley,Liverpool,4-1,4,1,1,1,5,3,H,"Watson, Tom",1,Away
108,1897-01-01,1896.0,Bolton Wanderers,Liverpool,1-4,1,4,1,1,5,-3,A,"Watson, Tom",4,Away
109,1897-01-02,1896.0,Liverpool,Sheffield United,0-0,0,0,1,1,0,0,D,"Watson, Tom",0,Anfield
110,1897-01-09,1896.0,Wolverhampton Wanderers,Liverpool,1-2,1,2,1,1,3,-1,A,"Watson, Tom",2,Away
111,1897-01-16,1896.0,Liverpool,Stoke City,1-0,1,0,1,1,1,1,H,"Watson, Tom",1,Anfield
112,1897-02-06,1896.0,Stoke City,Liverpool,6-1,6,1,1,1,7,5,H,"Watson, Tom",1,Away
113,1897-03-04,1896.0,Liverpool,Wolverhampton Wanderers,3-0,3,0,1,1,3,3,H,"Watson, Tom",3,Anfield
114,1897-03-13,1896.0,Aston Villa,Liverpool,0-0,0,0,1,1,0,0,D,"Watson, Tom",0,Away
115,1897-03-27,1896.0,Liverpool,Burnley,1-2,1,2,1,1,3,-1,A,"Watson, Tom",1,Anfield
116,1897-04-03,1896.0,Liverpool,Sheffield Wednesday,2-2,2,2,1,1,4,0,D,"Watson, Tom",2,Anfield
117,1897-04-10,1896.0,Liverpool,Preston North End,0-0,0,0,1,1,0,0,D,"Watson, Tom",0,Anfield
118,1897-09-04,1897.0,Stoke City,Liverpool,2-2,2,2,1,1,4,0,D,"Watson, Tom",2,Away
119,1897-09-11,1897.0,Liverpool,Preston North End,0-0,0,0,1,1,0,0,D,"Watson, Tom",0,Anfield
120,1897-09-18,1897.0,Sheffield Wednesday,Liverpool,4-2,4,2,1,1,6,2,H,"Watson, Tom",2,Away
121,1897-09-25,1897.0,Liverpool,Everton,3-1,3,1,1,1,4,2,H,"Watson, Tom",3,Anfield
122,1897-10-02,1897.0,Preston North End,Liverpool,1-1,1,1,1,1,2,0,D,"Watson, Tom",1,Away
123,1897-10-09,1897.0,Liverpool,Stoke City,4-0,4,0,1,1,4,4,H,"Watson, Tom",4,Anfield
124,1897-10-16,1897.0,Everton,Liverpool,3-0,3,0,1,1,3,3,H,"Watson, Tom",0,Away
125,1897-10-23,1897.0,Liverpool,Derby County,4-2,4,2,1,1,6,2,H,"Watson, Tom",4,Anfield
126,1897-10-30,1897.0,Aston Villa,Liverpool,3-1,3,1,1,1,4,2,H,"Watson, Tom",1,Away
127,1897-11-06,1897.0,Liverpool,Nottingham Forest,1-2,1,2,1,1,3,-1,A,"Watson, Tom",1,Anfield
128,1897-11-13,1897.0,West Bromwich Albion,Liverpool,2-1,2,1,1,1,3,1,H,"Watson, Tom",1,Away
129,1897-11-20,1897.0,Liverpool,Wolverhampton Wanderers,1-0,1,0,1,1,1,1,H,"Watson, Tom",1,Anfield
130,1897-11-27,1897.0,Nottingham Forest,Liverpool,2-3,2,3,1,1,5,-1,A,"Watson, Tom",3,Away
131,1897-12-11,1897.0,Wolverhampton Wanderers,Liverpool,2-1,2,1,1,1,3,1,H,"Watson, Tom",1,Away
132,1897-12-18,1897.0,Liverpool,Blackburn Rovers,0-1,0,1,1,1,1,-1,A,"Watson, Tom",0,Anfield
133,1897-12-25,1897.0,Bolton Wanderers,Liverpool,0-2,0,2,1,1,2,-2,A,"Watson, Tom",2,Away
134,1897-12-27,1897.0,Liverpool,Sunderland,0-2,0,2,1,1,2,-2,A,"Watson, Tom",0,Anfield
135,1897-12-29,1897.0,Sheffield United,Liverpool,1-2,1,2,1,1,3,-1,A,"Watson, Tom",2,Away
136,1898-01-01,1897.0,Liverpool,West Bromwich Albion,1-1,1,1,1,1,2,0,D,"Watson, Tom",1,Anfield
137,1898-01-08,1897.0,Blackburn Rovers,Liverpool,2-1,2,1,1,1,3,1,H,"Watson, Tom",1,Away
138,1898-01-22,1897.0,Sunderland,Liverpool,1-0,1,0,1,1,1,1,H,"Watson, Tom",0,Away
139,1898-02-05,1897.0,Liverpool,Sheffield United,0-4,0,4,1,1,4,-4,A,"Watson, Tom",0,Anfield
140,1898-03-12,1897.0,Liverpool,Notts County,2-0,2,0,1,1,2,2,H,"Watson, Tom",2,Anfield
141,1898-03-19,1897.0,Liverpool,Bolton Wanderers,1-1,1,1,1,1,2,0,D,"Watson, Tom",1,Anfield
142,1898-03-26,1897.0,Bury,Liverpool,0-2,0,2,1,1,2,-2,A,"Watson, Tom",2,Away
143,1898-03-31,1897.0,Liverpool,Bury,2-2,2,2,1,1,4,0,D,"Watson, Tom",2,Anfield
144,1898-04-02,1897.0,Notts County,Liverpool,3-2,3,2,1,1,5,1,H,"Watson, Tom",2,Away
145,1898-04-11,1897.0,Liverpool,Sheffield Wednesday,4-0,4,0,1,1,4,4,H,"Watson, Tom",4,Anfield
146,1898-04-12,1897.0,Derby County,Liverpool,3-1,3,1,1,1,4,2,H,"Watson, Tom",1,Away
147,1898-04-16,1897.0,Liverpool,Aston Villa,4-0,4,0,1,1,4,4,H,"Watson, Tom",4,Anfield
148,1898-09-03,1898.0,Liverpool,Sheffield Wednesday,4-0,4,0,1,1,4,4,H,"Watson, Tom",4,Anfield
149,1898-09-10,1898.0,Sunderland,Liverpool,1-0,1,0,1,1,1,1,H,"Watson, Tom",0,Away
150,1898-09-17,1898.0,Liverpool,Wolverhampton Wanderers,1-0,1,0,1,1,1,1,H,"Watson, Tom",1,Anfield
151,1898-09-24,1898.0,Everton,Liverpool,1-2,1,2,1,1,3,-1,A,"Watson, Tom",2,Away
152,1898-10-01,1898.0,Liverpool,Notts County,0-0,0,0,1,1,0,0,D,"Watson, Tom",0,Anfield
153,1898-10-08,1898.0,Stoke City,Liverpool,2-1,2,1,1,1,3,1,H,"Watson, Tom",1,Away
154,1898-10-15,1898.0,Liverpool,Aston Villa,0-3,0,3,1,1,3,-3,A,"Watson, Tom",0,Anfield
155,1898-10-22,1898.0,Burnley,Liverpool,2-1,2,1,1,1,3,1,H,"Watson, Tom",1,Away
156,1898-10-29,1898.0,Liverpool,Sheffield United,2-1,2,1,1,1,3,1,H,"Watson, Tom",2,Anfield
157,1898-11-05,1898.0,Newcastle United,Liverpool,3-0,3,0,1,1,3,3,H,"Watson, Tom",0,Away
158,1898-11-12,1898.0,Liverpool,Preston North End,3-1,3,1,1,1,4,2,H,"Watson, Tom",3,Anfield
159,1898-11-19,1898.0,Bury,Liverpool,3-0,3,0,1,1,3,3,H,"Watson, Tom",0,Away
160,1898-11-26,1898.0,Nottingham Forest,Liverpool,0-3,0,3,1,1,3,-3,A,"Watson, Tom",3,Away
161,1898-12-03,1898.0,Liverpool,Bolton Wanderers,2-0,2,0,1,1,2,2,H,"Watson, Tom",2,Anfield
162,1898-12-10,1898.0,Derby County,Liverpool,1-0,1,0,1,1,1,1,H,"Watson, Tom",0,Away
163,1898-12-17,1898.0,Liverpool,West Bromwich Albion,2-2,2,2,1,1,4,0,D,"Watson, Tom",2,Anfield
164,1898-12-24,1898.0,Blackburn Rovers,Liverpool,1-3,1,3,1,1,4,-2,A,"Watson, Tom",3,Away
165,1898-12-26,1898.0,West Bromwich Albion,Liverpool,0-1,0,1,1,1,1,-1,A,"Watson, Tom",1,Away
166,1898-12-27,1898.0,Notts County,Liverpool,1-1,1,1,1,1,2,0,D,"Watson, Tom",1,Away
167,1898-12-31,1898.0,Sheffield Wednesday,Liverpool,0-3,0,3,1,1,3,-3,A,"Watson, Tom",3,Away
168,1899-01-02,1898.0,Sheffield United,Liverpool,0-2,0,2,1,1,2,-2,A,"Watson, Tom",2,Away
169,1899-01-07,1898.0,Liverpool,Sunderland,0-0,0,0,1,1,0,0,D,"Watson, Tom",0,Anfield
170,1899-01-14,1898.0,Wolverhampton Wanderers,Liverpool,0-0,0,0,1,1,0,0,D,"Watson, Tom",0,Away
171,1899-01-21,1898.0,Liverpool,Everton,2-0,2,0,1,1,2,2,H,"Watson, Tom",2,Anfield
172,1899-02-04,1898.0,Liverpool,Stoke City,1-0,1,0,1,1,1,1,H,"Watson, Tom",1,Anfield
173,1899-02-18,1898.0,Liverpool,Burnley,2-0,2,0,1,1,2,2,H,"Watson, Tom",2,Anfield
174,1899-03-11,1898.0,Preston North End,Liverpool,1-2,1,2,1,1,3,-1,A,"Watson, Tom",2,Away
175,1899-03-25,1898.0,Liverpool,Nottingham Forest,0-1,0,1,1,1,1,-1,A,"Watson, Tom",0,Anfield
176,1899-04-01,1898.0,Bolton Wanderers,Liverpool,2-1,2,1,1,1,3,1,H,"Watson, Tom",1,Away
177,1899-04-03,1898.0,Liverpool,Newcastle United,3-2,3,2,1,1,5,1,H,"Watson, Tom",3,Anfield
178,1899-04-08,1898.0,Liverpool,Derby County,4-0,4,0,1,1,4,4,H,"Watson, Tom",4,Anfield
179,1899-04-20,1898.0,Liverpool,Bury,1-0,1,0,1,1,1,1,H,"Watson, Tom",1,Anfield
180,1899-04-22,1898.0,Liverpool,Blackburn Rovers,2-0,2,0,1,1,2,2,H,"Watson, Tom",2,Anfield
181,1899-04-29,1898.0,Aston Villa,Liverpool,5-0,5,0,1,1,5,5,H,"Watson, Tom",0,Away
182,1899-09-02,1899.0,Stoke City,Liverpool,3-2,3,2,1,1,5,1,H,"Watson, Tom",2,Away
183,1899-09-09,1899.0,Liverpool,Sunderland,0-2,0,2,1,1,2,-2,A,"Watson, Tom",0,Anfield
184,1899-09-16,1899.0,West Bromwich Albion,Liverpool,2-0,2,0,1,1,2,2,H,"Watson, Tom",0,Away
185,1899-09-23,1899.0,Liverpool,Everton,1-2,1,2,1,1,3,-1,A,"Watson, Tom",1,Anfield
186,1899-09-30,1899.0,Blackburn Rovers,Liverpool,2-0,2,0,1,1,2,2,H,"Watson, Tom",0,Away
187,1899-10-05,1899.0,Notts County,Liverpool,2-1,2,1,1,1,3,1,H,"Watson, Tom",1,Away
188,1899-10-07,1899.0,Liverpool,Derby County,0-2,0,2,1,1,2,-2,A,"Watson, Tom",0,Anfield
189,1899-10-14,1899.0,Bury,Liverpool,2-1,2,1,1,1,3,1,H,"Watson, Tom",1,Away
190,1899-10-21,1899.0,Liverpool,Notts County,3-1,3,1,1,1,4,2,H,"Watson, Tom",3,Anfield
191,1899-10-28,1899.0,Manchester City,Liverpool,0-1,0,1,1,1,1,-1,A,"Watson, Tom",1,Away
192,1899-11-04,1899.0,Liverpool,Sheffield United,2-2,2,2,1,1,4,0,D,"Watson, Tom",2,Anfield
193,1899-11-11,1899.0,Newcastle United,Liverpool,1-1,1,1,1,1,2,0,D,"Watson, Tom",1,Away
194,1899-11-18,1899.0,Liverpool,Aston Villa,3-3,3,3,1,1,6,0,D,"Watson, Tom",3,Anfield
195,1899-11-25,1899.0,Liverpool,Wolverhampton Wanderers,1-1,1,1,1,1,2,0,D,"Watson, Tom",1,Anfield
196,1899-12-02,1899.0,Burnley,Liverpool,2-1,2,1,1,1,3,1,H,"Watson, Tom",1,Away
197,1899-12-09,1899.0,Liverpool,Preston North End,1-0,1,0,1,1,1,1,H,"Watson, Tom",1,Anfield
198,1899-12-16,1899.0,Nottingham Forest,Liverpool,1-0,1,0,1,1,1,1,H,"Watson, Tom",0,Away
199,1899-12-23,1899.0,Liverpool,Glossop North End,5-2,5,2,1,1,7,3,H,"Watson, Tom",5,Anfield
200,1899-12-25,1899.0,Derby County,Liverpool,3-2,3,2,1,1,5,1,H,"Watson, Tom",2,Away
201,1899-12-29,1899.0,Liverpool,Stoke City,0-0,0,0,1,1,0,0,D,"Watson, Tom",0,Anfield
202,1900-01-06,1899.0,Sunderland,Liverpool,1-0,1,0,1,1,1,1,H,"Watson, Tom",0,Away
203,1900-01-13,1899.0,Liverpool,West Bromwich Albion,2-0,2,0,1,1,2,2,H,"Watson, Tom",2,Anfield
204,1900-01-20,1899.0,Everton,Liverpool,3-1,3,1,1,1,4,2,H,"Watson, Tom",1,Away
205,1900-02-03,1899.0,Liverpool,Blackburn Rovers,3-1,3,1,1,1,4,2,H,"Watson, Tom",3,Anfield
206,1900-03-03,1899.0,Liverpool,Manchester City,5-2,5,2,1,1,7,3,H,"Watson, Tom",5,Anfield
207,1900-03-10,1899.0,Sheffield United,Liverpool,1-2,1,2,1,1,3,-1,A,"Watson, Tom",2,Away
208,1900-03-17,1899.0,Liverpool,Newcastle United,2-0,2,0,1,1,2,2,H,"Watson, Tom",2,Anfield
209,1900-03-24,1899.0,Aston Villa,Liverpool,1-0,1,0,1,1,1,1,H,"Watson, Tom",0,Away
210,1900-03-31,1899.0,Wolverhampton Wanderers,Liverpool,0-1,0,1,1,1,1,-1,A,"Watson, Tom",1,Away
211,1900-04-07,1899.0,Liverpool,Burnley,0-1,0,1,1,1,1,-1,A,"Watson, Tom",0,Anfield
212,1900-04-09,1899.0,Liverpool,Bury,2-0,2,0,1,1,2,2,H,"Watson, Tom",2,Anfield
213,1900-04-14,1899.0,Preston North End,Liverpool,1-3,1,3,1,1,4,-2,A,"Watson, Tom",3,Away
214,1900-04-21,1899.0,Liverpool,Nottingham Forest,1-0,1,0,1,1,1,1,H,"Watson, Tom",1,Anfield
215,1900-04-28,1899.0,Glossop North End,Liverpool,1-2,1,2,1,1,3,-1,A,"Watson, Tom",2,Away
216,1900-09-01,1900.0,Liverpool,Blackburn Rovers,3-0,3,0,1,1,3,3,H,"Watson, Tom",3,Anfield
217,1900-09-08,1900.0,Stoke City,Liverpool,1-2,1,2,1,1,3,-1,A,"Watson, Tom",2,Away
218,1900-09-15,1900.0,Liverpool,West Bromwich Albion,5-0,5,0,1,1,5,5,H,"Watson, Tom",5,Anfield
219,1900-09-22,1900.0,Everton,Liverpool,1-1,1,1,1,1,2,0,D,"Watson, Tom",1,Away
220,1900-09-29,1900.0,Liverpool,Sunderland,1-2,1,2,1,1,3,-1,A,"Watson, Tom",1,Anfield
221,1900-10-06,1900.0,Derby County,Liverpool,2-3,2,3,1,1,5,-1,A,"Watson, Tom",3,Away
222,1900-10-13,1900.0,Liverpool,Bolton Wanderers,2-1,2,1,1,1,3,1,H,"Watson, Tom",2,Anfield
223,1900-10-20,1900.0,Notts County,Liverpool,3-0,3,0,1,1,3,3,H,"Watson, Tom",0,Away
224,1900-10-27,1900.0,Liverpool,Preston North End,3-2,3,2,1,1,5,1,H,"Watson, Tom",3,Anfield
225,1900-11-03,1900.0,Wolverhampton Wanderers,Liverpool,2-1,2,1,1,1,3,1,H,"Watson, Tom",1,Away
226,1900-11-10,1900.0,Liverpool,Aston Villa,5-1,5,1,1,1,6,4,H,"Watson, Tom",5,Anfield
227,1900-11-17,1900.0,Sheffield Wednesday,Liverpool,3-2,3,2,1,1,5,1,H,"Watson, Tom",2,Away
228,1900-11-24,1900.0,Newcastle United,Liverpool,1-1,1,1,1,1,2,0,D,"Watson, Tom",1,Away
229,1900-12-01,1900.0,Liverpool,Sheffield United,1-2,1,2,1,1,3,-1,A,"Watson, Tom",1,Anfield
230,1900-12-08,1900.0,Manchester City,Liverpool,3-4,3,4,1,1,7,-1,A,"Watson, Tom",4,Away
231,1900-12-15,1900.0,Liverpool,Bury,1-0,1,0,1,1,1,1,H,"Watson, Tom",1,Anfield
232,1900-12-22,1900.0,Nottingham Forest,Liverpool,0-0,0,0,1,1,0,0,D,"Watson, Tom",0,Away
233,1900-12-25,1900.0,Liverpool,Derby County,0-0,0,0,1,1,0,0,D,"Watson, Tom",0,Anfield
234,1900-12-29,1900.0,Blackburn Rovers,Liverpool,3-1,3,1,1,1,4,2,H,"Watson, Tom",1,Away
235,1901-01-01,1900.0,Liverpool,Stoke City,3-1,3,1,1,1,4,2,H,"Watson, Tom",3,Anfield
236,1901-01-19,1900.0,Liverpool,Everton,1-2,1,2,1,1,3,-1,A,"Watson, Tom",1,Anfield
237,1901-02-16,1900.0,Bolton Wanderers,Liverpool,1-0,1,0,1,1,1,1,H,"Watson, Tom",0,Away
238,1901-02-23,1900.0,Sunderland,Liverpool,0-1,0,1,1,1,1,-1,A,"Watson, Tom",1,Away
239,1901-03-02,1900.0,Preston North End,Liverpool,2-2,2,2,1,1,4,0,D,"Watson, Tom",2,Away
240,1901-03-09,1900.0,Liverpool,Wolverhampton Wanderers,1-0,1,0,1,1,1,1,H,"Watson, Tom",1,Anfield
241,1901-03-16,1900.0,Aston Villa,Liverpool,0-2,0,2,1,1,2,-2,A,"Watson, Tom",2,Away
242,1901-03-23,1900.0,Liverpool,Sheffield Wednesday,1-1,1,1,1,1,2,0,D,"Watson, Tom",1,Anfield
243,1901-03-30,1900.0,Liverpool,Newcastle United,3-0,3,0,1,1,3,3,H,"Watson, Tom",3,Anfield
244,1901-04-08,1900.0,Liverpool,Notts County,1-0,1,0,1,1,1,1,H,"Watson, Tom",1,Anfield
245,1901-04-13,1900.0,Liverpool,Manchester City,3-1,3,1,1,1,4,2,H,"Watson, Tom",3,Anfield
246,1901-04-20,1900.0,Bury,Liverpool,0-0,0,0,1,1,0,0,D,"Watson, Tom",0,Away
247,1901-04-22,1900.0,Sheffield United,Liverpool,0-2,0,2,1,1,2,-2,A,"Watson, Tom",2,Away
248,1901-04-27,1900.0,Liverpool,Nottingham Forest,2-0,2,0,1,1,2,2,H,"Watson, Tom",2,Anfield
249,1901-04-29,1900.0,West Bromwich Albion,Liverpool,0-1,0,1,1,1,1,-1,A,"Watson, Tom",1,Away
250,1901-09-02,1901.0,Birmingham City,Liverpool,0-0,0,0,1,1,0,0,D,"Watson, Tom",0,Away
251,1901-09-07,1901.0,Stoke City,Liverpool,1-0,1,0,1,1,1,1,H,"Watson, Tom",0,Away
252,1901-09-14,1901.0,Liverpool,Everton,2-2,2,2,1,1,4,0,D,"Watson, Tom",2,Anfield
253,1901-09-21,1901.0,Sunderland,Liverpool,1-1,1,1,1,1,2,0,D,"Watson, Tom",1,Away
254,1901-09-28,1901.0,Liverpool,Birmingham City,3-1,3,1,1,1,4,2,H,"Watson, Tom",3,Anfield
255,1901-10-05,1901.0,Derby County,Liverpool,1-1,1,1,1,1,2,0,D,"Watson, Tom",1,Away
256,1901-10-12,1901.0,Liverpool,Sheffield Wednesday,1-2,1,2,1,1,3,-1,A,"Watson, Tom",1,Anfield
257,1901-10-19,1901.0,Notts County,Liverpool,2-2,2,2,1,1,4,0,D,"Watson, Tom",2,Away
258,1901-10-26,1901.0,Liverpool,Bolton Wanderers,1-1,1,1,1,1,2,0,D,"Watson, Tom",1,Anfield
259,1901-11-02,1901.0,Manchester City,Liverpool,2-3,2,3,1,1,5,-1,A,"Watson, Tom",3,Away
260,1901-11-09,1901.0,Liverpool,Wolverhampton Wanderers,4-1,4,1,1,1,5,3,H,"Watson, Tom",4,Anfield
261,1901-11-23,1901.0,Newcastle United,Liverpool,1-0,1,0,1,1,1,1,H,"Watson, Tom",0,Away
262,1901-11-30,1901.0,Liverpool,Aston Villa,1-0,1,0,1,1,1,1,H,"Watson, Tom",1,Anfield
263,1901-12-07,1901.0,Sheffield United,Liverpool,2-1,2,1,1,1,3,1,H,"Watson, Tom",1,Away
264,1901-12-14,1901.0,Liverpool,Nottingham Forest,0-2,0,2,1,1,2,-2,A,"Watson, Tom",0,Anfield
265,1901-12-26,1901.0,Liverpool,Sunderland,0-1,0,1,1,1,1,-1,A,"Watson, Tom",0,Anfield
266,1901-12-28,1901.0,Liverpool,Blackburn Rovers,1-0,1,0,1,1,1,1,H,"Watson, Tom",1,Anfield
267,1902-01-04,1901.0,Liverpool,Stoke City,7-0,7,0,1,1,7,7,H,"Watson, Tom",7,Anfield
268,1902-01-11,1901.0,Everton,Liverpool,4-0,4,0,1,1,4,4,H,"Watson, Tom",0,Away
269,1902-02-01,1901.0,Bury,Liverpool,0-0,0,0,1,1,0,0,D,"Watson, Tom",0,Away
270,1902-02-15,1901.0,Liverpool,Notts County,0-1,0,1,1,1,1,-1,A,"Watson, Tom",0,Anfield
271,1902-02-22,1901.0,Bolton Wanderers,Liverpool,1-0,1,0,1,1,1,1,H,"Watson, Tom",0,Away
272,1902-03-01,1901.0,Liverpool,Manchester City,4-0,4,0,1,1,4,4,H,"Watson, Tom",4,Anfield
273,1902-03-08,1901.0,Wolverhampton Wanderers,Liverpool,3-1,3,1,1,1,4,2,H,"Watson, Tom",1,Away
274,1902-03-15,1901.0,Grimsby Town,Liverpool,1-1,1,1,1,1,2,0,D,"Watson, Tom",1,Away
275,1902-03-22,1901.0,Liverpool,Newcastle United,0-1,0,1,1,1,1,-1,A,"Watson, Tom",0,Anfield
276,1902-03-29,1901.0,Aston Villa,Liverpool,0-1,0,1,1,1,1,-1,A,"Watson, Tom",1,Away
277,1902-04-01,1901.0,Sheffield Wednesday,Liverpool,1-1,1,1,1,1,2,0,D,"Watson, Tom",1,Away
278,1902-04-05,1901.0,Liverpool,Sheffield United,1-0,1,0,1,1,1,1,H,"Watson, Tom",1,Anfield
279,1902-04-12,1901.0,Nottingham Forest,Liverpool,1-1,1,1,1,1,2,0,D,"Watson, Tom",1,Away
280,1902-04-14,1901.0,Liverpool,Derby County,0-2,0,2,1,1,2,-2,A,"Watson, Tom",0,Anfield
281,1902-04-19,1901.0,Liverpool,Bury,1-0,1,0,1,1,1,1,H,"Watson, Tom",1,Anfield
282,1902-04-21,1901.0,Liverpool,Grimsby Town,2-2,2,2,1,1,4,0,D,"Watson, Tom",2,Anfield
283,1902-04-26,1901.0,Blackburn Rovers,Liverpool,1-1,1,1,1,1,2,0,D,"Watson, Tom",1,Away
284,1902-09-06,1902.0,Liverpool,Blackburn Rovers,5-2,5,2,1,1,7,3,H,"Watson, Tom",5,Anfield
285,1902-09-13,1902.0,Sunderland,Liverpool,2-1,2,1,1,1,3,1,H,"Watson, Tom",1,Away
286,1902-09-20,1902.0,Liverpool,Stoke City,1-1,1,1,1,1,2,0,D,"Watson, Tom",1,Anfield
287,1902-09-27,1902.0,Everton,Liverpool,3-1,3,1,1,1,4,2,H,"Watson, Tom",1,Away
288,1902-10-04,1902.0,Liverpool,Sheffield Wednesday,4-2,4,2,1,1,6,2,H,"Watson, Tom",4,Anfield
289,1902-10-11,1902.0,West Bromwich Albion,Liverpool,1-2,1,2,1,1,3,-1,A,"Watson, Tom",2,Away
290,1902-10-18,1902.0,Liverpool,Notts County,0-2,0,2,1,1,2,-2,A,"Watson, Tom",0,Anfield
291,1902-10-25,1902.0,Bolton Wanderers,Liverpool,1-1,1,1,1,1,2,0,D,"Watson, Tom",1,Away
292,1902-11-01,1902.0,Liverpool,Middlesbrough,5-0,5,0,1,1,5,5,H,"Watson, Tom",5,Anfield
293,1902-11-08,1902.0,Newcastle United,Liverpool,1-2,1,2,1,1,3,-1,A,"Watson, Tom",2,Away
294,1902-11-15,1902.0,Liverpool,Wolverhampton Wanderers,4-1,4,1,1,1,5,3,H,"Watson, Tom",4,Anfield
295,1902-11-22,1902.0,Derby County,Liverpool,2-1,2,1,1,1,3,1,H,"Watson, Tom",1,Away
296,1902-11-29,1902.0,Sheffield United,Liverpool,2-0,2,0,1,1,2,2,H,"Watson, Tom",0,Away
297,1902-12-06,1902.0,Liverpool,Grimsby Town,9-2,9,2,1,1,11,7,H,"Watson, Tom",9,Anfield
298,1902-12-13,1902.0,Aston Villa,Liverpool,1-2,1,2,1,1,3,-1,A,"Watson, Tom",2,Away
299,1902-12-20,1902.0,Liverpool,Nottingham Forest,2-1,2,1,1,1,3,1,H,"Watson, Tom",2,Anfield
300,1902-12-25,1902.0,Liverpool,Bolton Wanderers,5-1,5,1,1,1,6,4,H,"Watson, Tom",5,Anfield
301,1902-12-27,1902.0,Bury,Liverpool,3-1,3,1,1,1,4,2,H,"Watson, Tom",1,Away
302,1903-01-01,1902.0,Liverpool,West Bromwich Albion,0-2,0,2,1,1,2,-2,A,"Watson, Tom",0,Anfield
303,1903-01-03,1902.0,Blackburn Rovers,Liverpool,3-1,3,1,1,1,4,2,H,"Watson, Tom",1,Away
304,1903-01-17,1902.0,Stoke City,Liverpool,1-0,1,0,1,1,1,1,H,"Watson, Tom",0,Away
305,1903-01-31,1902.0,Sheffield Wednesday,Liverpool,3-1,3,1,1,1,4,2,H,"Watson, Tom",1,Away
306,1903-02-14,1902.0,Notts County,Liverpool,1-2,1,2,1,1,3,-1,A,"Watson, Tom",2,Away
307,1903-02-28,1902.0,Middlesbrough,Liverpool,0-2,0,2,1,1,2,-2,A,"Watson, Tom",2,Away
308,1903-03-07,1902.0,Liverpool,Newcastle United,3-0,3,0,1,1,3,3,H,"Watson, Tom",3,Anfield
309,1903-03-23,1902.0,Liverpool,Derby County,3-1,3,1,1,1,4,2,H,"Watson, Tom",3,Anfield
310,1903-03-28,1902.0,Liverpool,Sheffield United,2-4,2,4,1,1,6,-2,A,"Watson, Tom",2,Anfield
311,1903-03-30,1902.0,Liverpool,Sunderland,1-1,1,1,1,1,2,0,D,"Watson, Tom",1,Anfield
312,1903-04-04,1902.0,Grimsby Town,Liverpool,3-1,3,1,1,1,4,2,H,"Watson, Tom",1,Away
313,1903-04-10,1902.0,Liverpool,Everton,0-0,0,0,1,1,0,0,D,"Watson, Tom",0,Anfield
314,1903-04-11,1902.0,Liverpool,Aston Villa,2-1,2,1,1,1,3,1,H,"Watson, Tom",2,Anfield
315,1903-04-18,1902.0,Nottingham Forest,Liverpool,1-0,1,0,1,1,1,1,H,"Watson, Tom",0,Away
316,1903-04-25,1902.0,Liverpool,Bury,2-0,2,0,1,1,2,2,H,"Watson, Tom",2,Anfield
317,1903-04-27,1902.0,Wolverhampton Wanderers,Liverpool,0-2,0,2,1,1,2,-2,A,"Watson, Tom",2,Away
318,1903-09-05,1903.0,Nottingham Forest,Liverpool,2-1,2,1,1,1,3,1,H,"Watson, Tom",1,Away
319,1903-09-12,1903.0,Liverpool,Sheffield Wednesday,1-3,1,3,1,1,4,-2,A,"Watson, Tom",1,Anfield
320,1903-09-19,1903.0,Sunderland,Liverpool,2-1,2,1,1,1,3,1,H,"Watson, Tom",1,Away
321,1903-09-26,1903.0,Liverpool,West Bromwich Albion,1-3,1,3,1,1,4,-2,A,"Watson, Tom",1,Anfield
322,1903-10-01,1903.0,Notts County,Liverpool,4-2,4,2,1,1,6,2,H,"Watson, Tom",2,Away
323,1903-10-03,1903.0,Birmingham City,Liverpool,1-2,1,2,1,1,3,-1,A,"Watson, Tom",2,Away
324,1903-10-10,1903.0,Liverpool,Everton,2-2,2,2,1,1,4,0,D,"Watson, Tom",2,Anfield
325,1903-10-17,1903.0,Stoke City,Liverpool,5-2,5,2,1,1,7,3,H,"Watson, Tom",2,Away
326,1903-10-24,1903.0,Liverpool,Derby County,3-1,3,1,1,1,4,2,H,"Watson, Tom",3,Anfield
327,1903-10-31,1903.0,Manchester City,Liverpool,3-2,3,2,1,1,5,1,H,"Watson, Tom",2,Away
328,1903-11-07,1903.0,Liverpool,Notts County,2-1,2,1,1,1,3,1,H,"Watson, Tom",2,Anfield
329,1903-11-14,1903.0,Sheffield United,Liverpool,2-1,2,1,1,1,3,1,H,"Watson, Tom",1,Away
330,1903-11-21,1903.0,Liverpool,Newcastle United,1-0,1,0,1,1,1,1,H,"Watson, Tom",1,Anfield
331,1903-11-28,1903.0,Aston Villa,Liverpool,2-1,2,1,1,1,3,1,H,"Watson, Tom",1,Away
332,1903-12-12,1903.0,Liverpool,Wolverhampton Wanderers,1-2,1,2,1,1,3,-1,A,"Watson, Tom",1,Anfield
333,1903-12-19,1903.0,Bury,Liverpool,2-2,2,2,1,1,4,0,D,"Watson, Tom",2,Away
334,1903-12-25,1903.0,Derby County,Liverpool,2-0,2,0,1,1,2,2,H,"Watson, Tom",0,Away
335,1903-12-26,1903.0,Liverpool,Blackburn Rovers,1-2,1,2,1,1,3,-1,A,"Watson, Tom",1,Anfield
336,1903-12-28,1903.0,Wolverhampton Wanderers,Liverpool,4-2,4,2,1,1,6,2,H,"Watson, Tom",2,Away
337,1904-01-02,1903.0,Liverpool,Nottingham Forest,0-0,0,0,1,1,0,0,D,"Watson, Tom",0,Anfield
338,1904-01-09,1903.0,Sheffield Wednesday,Liverpool,2-1,2,1,1,1,3,1,H,"Watson, Tom",1,Away
339,1904-01-16,1903.0,Liverpool,Sunderland,2-1,2,1,1,1,3,1,H,"Watson, Tom",2,Anfield
340,1904-01-23,1903.0,West Bromwich Albion,Liverpool,2-2,2,2,1,1,4,0,D,"Watson, Tom",2,Away
341,1904-01-30,1903.0,Liverpool,Birmingham City,0-2,0,2,1,1,2,-2,A,"Watson, Tom",0,Anfield
342,1904-02-13,1903.0,Liverpool,Stoke City,0-0,0,0,1,1,0,0,D,"Watson, Tom",0,Anfield
343,1904-02-22,1903.0,Liverpool,Middlesbrough,1-0,1,0,1,1,1,1,H,"Watson, Tom",1,Anfield
344,1904-02-27,1903.0,Liverpool,Manchester City,2-2,2,2,1,1,4,0,D,"Watson, Tom",2,Anfield
345,1904-03-12,1903.0,Liverpool,Sheffield United,3-0,3,0,1,1,3,3,H,"Watson, Tom",3,Anfield
346,1904-03-19,1903.0,Newcastle United,Liverpool,1-1,1,1,1,1,2,0,D,"Watson, Tom",1,Away
347,1904-03-26,1903.0,Liverpool,Aston Villa,1-1,1,1,1,1,2,0,D,"Watson, Tom",1,Anfield
348,1904-04-01,1903.0,Everton,Liverpool,5-2,5,2,1,1,7,3,H,"Watson, Tom",2,Away
349,1904-04-02,1903.0,Middlesbrough,Liverpool,1-0,1,0,1,1,1,1,H,"Watson, Tom",0,Away
350,1904-04-16,1903.0,Liverpool,Bury,3-0,3,0,1,1,3,3,H,"Watson, Tom",3,Anfield
351,1904-04-23,1903.0,Blackburn Rovers,Liverpool,2-3,2,3,1,1,5,-1,A,"Watson, Tom",3,Away
352,1904-09-01,1904.0,Liverpool,Burton United,2-0,2,0,2,2,2,2,H,"Watson, Tom",2,Anfield
353,1904-09-03,1904.0,Liverpool,Glossop North End,2-2,2,2,2,2,4,0,D,"Watson, Tom",2,Anfield
354,1904-09-10,1904.0,Chesterfield,Liverpool,1-1,1,1,2,2,2,0,D,"Watson, Tom",1,Away
355,1904-09-17,1904.0,Liverpool,Bradford City,4-1,4,1,2,2,5,3,H,"Watson, Tom",4,Anfield
356,1904-09-24,1904.0,Lincoln City,Liverpool,0-2,0,2,2,2,2,-2,A,"Watson, Tom",2,Away
357,1904-10-01,1904.0,Liverpool,Leicester City,4-0,4,0,2,2,4,4,H,"Watson, Tom",4,Anfield
358,1904-10-08,1904.0,Barnsley,Liverpool,0-2,0,2,2,2,2,-2,A,"Watson, Tom",2,Away
359,1904-10-15,1904.0,Liverpool,West Bromwich Albion,3-2,3,2,2,2,5,1,H,"Watson, Tom",3,Anfield
360,1904-10-22,1904.0,Burnley,Liverpool,0-2,0,2,2,2,2,-2,A,"Watson, Tom",2,Away
361,1904-10-29,1904.0,Liverpool,Grimsby Town,5-0,5,0,2,2,5,5,H,"Watson, Tom",5,Anfield
362,1904-11-05,1904.0,Blackpool,Liverpool,0-3,0,3,2,2,3,-3,A,"Watson, Tom",3,Away
363,1904-11-12,1904.0,Port Vale,Liverpool,1-2,1,2,2,2,3,-1,A,"Watson, Tom",2,Away
364,1904-11-19,1904.0,Gainsborough Trinity,Liverpool,1-2,1,2,2,2,3,-1,A,"Watson, Tom",2,Away
365,1904-12-03,1904.0,Bolton Wanderers,Liverpool,2-0,2,0,2,2,2,2,H,"Watson, Tom",0,Away
366,1904-12-17,1904.0,Liverpool,Bristol City,3-1,3,1,2,2,4,2,H,"Watson, Tom",3,Anfield
367,1904-12-24,1904.0,Manchester United,Liverpool,3-1,3,1,2,2,4,2,H,"Watson, Tom",1,Away
368,1904-12-26,1904.0,Liverpool,Barnsley,2-1,2,1,2,2,3,1,H,"Watson, Tom",2,Anfield
369,1904-12-31,1904.0,Glossop North End,Liverpool,0-2,0,2,2,2,2,-2,A,"Watson, Tom",2,Away
370,1905-01-07,1904.0,Liverpool,Chesterfield,6-1,6,1,2,2,7,5,H,"Watson, Tom",6,Anfield
371,1905-01-21,1904.0,Liverpool,Lincoln City,1-1,1,1,2,2,2,0,D,"Watson, Tom",1,Anfield
372,1905-01-28,1904.0,Leicester City,Liverpool,0-3,0,3,2,2,3,-3,A,"Watson, Tom",3,Away
373,1905-02-11,1904.0,West Bromwich Albion,Liverpool,0-2,0,2,2,2,2,-2,A,"Watson, Tom",2,Away
374,1905-02-25,1904.0,Grimsby Town,Liverpool,0-1,0,1,2,2,1,-1,A,"Watson, Tom",1,Away
375,1905-03-04,1904.0,Liverpool,Blackpool,5-0,5,0,2,2,5,5,H,"Watson, Tom",5,Anfield
376,1905-03-07,1904.0,Bradford City,Liverpool,2-4,2,4,2,2,6,-2,A,"Watson, Tom",4,Away
377,1905-03-11,1904.0,Doncaster Rovers,Liverpool,1-4,1,4,2,2,5,-3,A,"Watson, Tom",4,Away
378,1905-03-18,1904.0,Liverpool,Gainsborough Trinity,6-1,6,1,2,2,7,5,H,"Watson, Tom",6,Anfield
379,1905-03-25,1904.0,Burton United,Liverpool,2-1,2,1,2,2,3,1,H,"Watson, Tom",1,Away
380,1905-04-01,1904.0,Liverpool,Bolton Wanderers,1-1,1,1,2,2,2,0,D,"Watson, Tom",1,Anfield
381,1905-04-08,1904.0,Liverpool,Port Vale,8-1,8,1,2,2,9,7,H,"Watson, Tom",8,Anfield
382,1905-04-15,1904.0,Bristol City,Liverpool,0-1,0,1,2,2,1,-1,A,"Watson, Tom",1,Away
383,1905-04-21,1904.0,Liverpool,Doncaster Rovers,1-0,1,0,2,2,1,1,H,"Watson, Tom",1,Anfield
384,1905-04-22,1904.0,Liverpool,Manchester United,4-0,4,0,2,2,4,4,H,"Watson, Tom",4,Anfield
385,1905-04-29,1904.0,Liverpool,Burnley,3-0,3,0,2,2,3,3,H,"Watson, Tom",3,Anfield
386,1905-09-02,1905.0,Arsenal,Liverpool,3-1,3,1,1,1,4,2,H,"Watson, Tom",1,Away
387,1905-09-09,1905.0,Liverpool,Blackburn Rovers,1-3,1,3,1,1,4,-2,A,"Watson, Tom",1,Anfield
388,1905-09-11,1905.0,Aston Villa,Liverpool,5-0,5,0,1,1,5,5,H,"Watson, Tom",0,Away
389,1905-09-16,1905.0,Sunderland,Liverpool,1-2,1,2,1,1,3,-1,A,"Watson, Tom",2,Away
390,1905-09-23,1905.0,Liverpool,Birmingham City,2-0,2,0,1,1,2,2,H,"Watson, Tom",2,Anfield
391,1905-09-30,1905.0,Everton,Liverpool,4-2,4,2,1,1,6,2,H,"Watson, Tom",2,Away
392,1905-10-07,1905.0,Liverpool,Derby County,4-1,4,1,1,1,5,3,H,"Watson, Tom",4,Anfield
393,1905-10-14,1905.0,Sheffield Wednesday,Liverpool,3-2,3,2,1,1,5,1,H,"Watson, Tom",2,Away
394,1905-10-21,1905.0,Liverpool,Nottingham Forest,4-1,4,1,1,1,5,3,H,"Watson, Tom",4,Anfield
395,1905-10-28,1905.0,Manchester City,Liverpool,0-1,0,1,1,1,1,-1,A,"Watson, Tom",1,Away
396,1905-11-04,1905.0,Liverpool,Bury,3-1,3,1,1,1,4,2,H,"Watson, Tom",3,Anfield
397,1905-11-11,1905.0,Middlesbrough,Liverpool,1-5,1,5,1,1,6,-4,A,"Watson, Tom",5,Away
398,1905-11-18,1905.0,Liverpool,Preston North End,1-1,1,1,1,1,2,0,D,"Watson, Tom",1,Anfield
399,1905-11-25,1905.0,Newcastle United,Liverpool,2-3,2,3,1,1,5,-1,A,"Watson, Tom",3,Away
400,1905-12-02,1905.0,Liverpool,Aston Villa,3-0,3,0,1,1,3,3,H,"Watson, Tom",3,Anfield
401,1905-12-09,1905.0,Liverpool,Wolverhampton Wanderers,4-0,4,0,1,1,4,4,H,"Watson, Tom",4,Anfield
402,1905-12-16,1905.0,Sheffield United,Liverpool,1-2,1,2,1,1,3,-1,A,"Watson, Tom",2,Away
403,1905-12-23,1905.0,Liverpool,Notts County,2-0,2,0,1,1,2,2,H,"Watson, Tom",2,Anfield
404,1905-12-25,1905.0,Liverpool,Bolton Wanderers,2-2,2,2,1,1,4,0,D,"Watson, Tom",2,Anfield
405,1905-12-26,1905.0,Stoke City,Liverpool,2-1,2,1,1,1,3,1,H,"Watson, Tom",1,Away
406,1905-12-30,1905.0,Liverpool,Arsenal,3-0,3,0,1,1,3,3,H,"Watson, Tom",3,Anfield
407,1906-01-01,1905.0,Liverpool,Stoke City,3-1,3,1,1,1,4,2,H,"Watson, Tom",3,Anfield
408,1906-01-06,1905.0,Blackburn Rovers,Liverpool,0-0,0,0,1,1,0,0,D,"Watson, Tom",0,Away
409,1906-01-20,1905.0,Liverpool,Sunderland,2-0,2,0,1,1,2,2,H,"Watson, Tom",2,Anfield
410,1906-01-27,1905.0,Birmingham City,Liverpool,1-0,1,0,1,1,1,1,H,"Watson, Tom",0,Away
411,1906-02-10,1905.0,Derby County,Liverpool,0-3,0,3,1,1,3,-3,A,"Watson, Tom",3,Away
412,1906-02-17,1905.0,Liverpool,Sheffield Wednesday,2-1,2,1,1,1,3,1,H,"Watson, Tom",2,Anfield
413,1906-03-03,1905.0,Liverpool,Manchester City,0-1,0,1,1,1,1,-1,A,"Watson, Tom",0,Anfield
414,1906-03-14,1905.0,Nottingham Forest,Liverpool,1-2,1,2,1,1,3,-1,A,"Watson, Tom",2,Away
415,1906-03-17,1905.0,Liverpool,Middlesbrough,6-1,6,1,1,1,7,5,H,"Watson, Tom",6,Anfield
416,1906-03-21,1905.0,Notts County,Liverpool,3-0,3,0,1,1,3,3,H,"Watson, Tom",0,Away
417,1906-03-24,1905.0,Preston North End,Liverpool,1-2,1,2,1,1,3,-1,A,"Watson, Tom",2,Away
418,1906-04-02,1905.0,Bury,Liverpool,0-0,0,0,1,1,0,0,D,"Watson, Tom",0,Away
419,1906-04-09,1905.0,Liverpool,Newcastle United,3-0,3,0,1,1,3,3,H,"Watson, Tom",3,Anfield
420,1906-04-13,1905.0,Liverpool,Everton,1-1,1,1,1,1,2,0,D,"Watson, Tom",1,Anfield
421,1906-04-14,1905.0,Wolverhampton Wanderers,Liverpool,0-2,0,2,1,1,2,-2,A,"Watson, Tom",2,Away
422,1906-04-16,1905.0,Bolton Wanderers,Liverpool,3-2,3,2,1,1,5,1,H,"Watson, Tom",2,Away
423,1906-04-21,1905.0,Liverpool,Sheffield United,3-1,3,1,1,1,4,2,H,"Watson, Tom",3,Anfield
424,1906-09-01,1906.0,Liverpool,Stoke City,1-0,1,0,1,1,1,1,H,"Watson, Tom",1,Anfield
425,1906-09-08,1906.0,Blackburn Rovers,Liverpool,1-1,1,1,1,1,2,0,D,"Watson, Tom",1,Away
426,1906-09-10,1906.0,Liverpool,Bury,2-2,2,2,1,1,4,0,D,"Watson, Tom",2,Anfield
427,1906-09-15,1906.0,Liverpool,Sunderland,1-2,1,2,1,1,3,-1,A,"Watson, Tom",1,Anfield
428,1906-09-22,1906.0,Birmingham City,Liverpool,2-1,2,1,1,1,3,1,H,"Watson, Tom",1,Away
429,1906-09-29,1906.0,Liverpool,Everton,1-2,1,2,1,1,3,-1,A,"Watson, Tom",1,Anfield
430,1906-10-06,1906.0,Arsenal,Liverpool,2-1,2,1,1,1,3,1,H,"Watson, Tom",1,Away
431,1906-10-13,1906.0,Liverpool,Sheffield Wednesday,1-2,1,2,1,1,3,-1,A,"Watson, Tom",1,Anfield
432,1906-10-20,1906.0,Bury,Liverpool,1-3,1,3,1,1,4,-2,A,"Watson, Tom",3,Away
433,1906-10-27,1906.0,Liverpool,Manchester City,5-4,5,4,1,1,9,1,H,"Watson, Tom",5,Anfield
434,1906-11-03,1906.0,Middlesbrough,Liverpool,0-1,0,1,1,1,1,-1,A,"Watson, Tom",1,Away
435,1906-11-10,1906.0,Liverpool,Preston North End,6-1,6,1,1,1,7,5,H,"Watson, Tom",6,Anfield
436,1906-11-17,1906.0,Newcastle United,Liverpool,2-0,2,0,1,1,2,2,H,"Watson, Tom",0,Away
437,1906-11-24,1906.0,Liverpool,Aston Villa,5-2,5,2,1,1,7,3,H,"Watson, Tom",5,Anfield
438,1906-12-01,1906.0,Derby County,Liverpool,0-1,0,1,1,1,1,-1,A,"Watson, Tom",1,Away
439,1906-12-08,1906.0,Bristol City,Liverpool,3-1,3,1,1,1,4,2,H,"Watson, Tom",1,Away
440,1906-12-15,1906.0,Liverpool,Notts County,5-1,5,1,1,1,6,4,H,"Watson, Tom",5,Anfield
441,1906-12-22,1906.0,Sheffield United,Liverpool,1-0,1,0,1,1,1,1,H,"Watson, Tom",0,Away
442,1906-12-25,1906.0,Manchester United,Liverpool,0-0,0,0,1,1,0,0,D,"Watson, Tom",0,Away
443,1906-12-26,1906.0,Liverpool,Bolton Wanderers,0-2,0,2,1,1,2,-2,A,"Watson, Tom",0,Anfield
444,1907-01-01,1906.0,Bolton Wanderers,Liverpool,3-0,3,0,1,1,3,3,H,"Watson, Tom",0,Away
445,1907-01-05,1906.0,Liverpool,Blackburn Rovers,0-2,0,2,1,1,2,-2,A,"Watson, Tom",0,Anfield
446,1907-01-19,1906.0,Sunderland,Liverpool,5-5,5,5,1,1,10,0,D,"Watson, Tom",5,Away
447,1907-01-26,1906.0,Liverpool,Birmingham City,2-0,2,0,1,1,2,2,H,"Watson, Tom",2,Anfield
448,1907-02-09,1906.0,Liverpool,Arsenal,4-0,4,0,1,1,4,4,H,"Watson, Tom",4,Anfield
449,1907-02-16,1906.0,Sheffield Wednesday,Liverpool,2-3,2,3,1,1,5,-1,A,"Watson, Tom",3,Away
450,1907-03-02,1906.0,Manchester City,Liverpool,1-0,1,0,1,1,1,1,H,"Watson, Tom",0,Away
451,1907-03-11,1906.0,Stoke City,Liverpool,1-1,1,1,1,1,2,0,D,"Watson, Tom",1,Away
452,1907-03-16,1906.0,Preston North End,Liverpool,3-1,3,1,1,1,4,2,H,"Watson, Tom",1,Away
453,1907-03-23,1906.0,Liverpool,Newcastle United,4-1,4,1,1,1,5,3,H,"Watson, Tom",4,Anfield
454,1907-03-29,1906.0,Everton,Liverpool,0-0,0,0,1,1,0,0,D,"Watson, Tom",0,Away
455,1907-03-30,1906.0,Aston Villa,Liverpool,4-0,4,0,1,1,4,4,H,"Watson, Tom",0,Away
456,1907-04-01,1906.0,Liverpool,Manchester United,0-1,0,1,1,1,1,-1,A,"Watson, Tom",0,Anfield
457,1907-04-06,1906.0,Liverpool,Derby County,2-0,2,0,1,1,2,2,H,"Watson, Tom",2,Anfield
458,1907-04-13,1906.0,Liverpool,Bristol City,2-4,2,4,1,1,6,-2,A,"Watson, Tom",2,Anfield
459,1907-04-17,1906.0,Liverpool,Middlesbrough,2-4,2,4,1,1,6,-2,A,"Watson, Tom",2,Anfield
460,1907-04-20,1906.0,Notts County,Liverpool,2-0,2,0,1,1,2,2,H,"Watson, Tom",0,Away
461,1907-04-27,1906.0,Liverpool,Sheffield United,2-2,2,2,1,1,4,0,D,"Watson, Tom",2,Anfield
462,1907-09-02,1907.0,Nottingham Forest,Liverpool,3-1,3,1,1,1,4,2,H,"Watson, Tom",1,Away
463,1907-09-07,1907.0,Manchester United,Liverpool,4-0,4,0,1,1,4,4,H,"Watson, Tom",0,Away
464,1907-09-14,1907.0,Liverpool,Blackburn Rovers,2-0,2,0,1,1,2,2,H,"Watson, Tom",2,Anfield
465,1907-09-16,1907.0,Sheffield United,Liverpool,0-0,0,0,1,1,0,0,D,"Watson, Tom",0,Away
466,1907-09-21,1907.0,Bolton Wanderers,Liverpool,0-4,0,4,1,1,4,-4,A,"Watson, Tom",4,Away
467,1907-09-28,1907.0,Liverpool,Birmingham City,3-4,3,4,1,1,7,-1,A,"Watson, Tom",3,Anfield
468,1907-10-05,1907.0,Everton,Liverpool,2-4,2,4,1,1,6,-2,A,"Watson, Tom",4,Away
469,1907-10-12,1907.0,Liverpool,Sunderland,1-0,1,0,1,1,1,1,H,"Watson, Tom",1,Anfield
470,1907-10-19,1907.0,Arsenal,Liverpool,2-1,2,1,1,1,3,1,H,"Watson, Tom",1,Away
471,1907-10-26,1907.0,Liverpool,Sheffield Wednesday,3-0,3,0,1,1,3,3,H,"Watson, Tom",3,Anfield
472,1907-11-02,1907.0,Bristol City,Liverpool,2-0,2,0,1,1,2,2,H,"Watson, Tom",0,Away
473,1907-11-09,1907.0,Liverpool,Notts County,6-0,6,0,1,1,6,6,H,"Watson, Tom",6,Anfield
474,1907-11-16,1907.0,Manchester City,Liverpool,1-1,1,1,1,1,2,0,D,"Watson, Tom",1,Away
475,1907-11-23,1907.0,Liverpool,Preston North End,1-2,1,2,1,1,3,-1,A,"Watson, Tom",1,Anfield
476,1907-12-07,1907.0,Liverpool,Aston Villa,5-0,5,0,1,1,5,5,H,"Watson, Tom",5,Anfield
477,1907-12-14,1907.0,Liverpool,Newcastle United,1-5,1,5,1,1,6,-4,A,"Watson, Tom",1,Anfield
478,1907-12-21,1907.0,Middlesbrough,Liverpool,3-1,3,1,1,1,4,2,H,"Watson, Tom",1,Away
479,1907-12-25,1907.0,Liverpool,Chelsea,1-4,1,4,1,1,5,-3,A,"Watson, Tom",1,Anfield
480,1907-12-28,1907.0,Liverpool,Sheffield United,3-0,3,0,1,1,3,3,H,"Watson, Tom",3,Anfield
481,1908-01-01,1907.0,Liverpool,Nottingham Forest,0-0,0,0,1,1,0,0,D,"Watson, Tom",0,Anfield
482,1908-01-18,1907.0,Liverpool,Bolton Wanderers,1-0,1,0,1,1,1,1,H,"Watson, Tom",1,Anfield
483,1908-01-25,1907.0,Birmingham City,Liverpool,1-1,1,1,1,1,2,0,D,"Watson, Tom",1,Away
484,1908-02-08,1907.0,Sunderland,Liverpool,1-0,1,0,1,1,1,1,H,"Watson, Tom",0,Away
485,1908-02-15,1907.0,Liverpool,Arsenal,4-1,4,1,1,1,5,3,H,"Watson, Tom",4,Anfield
486,1908-02-29,1907.0,Liverpool,Bristol City,3-1,3,1,1,1,4,2,H,"Watson, Tom",3,Anfield
487,1908-03-07,1907.0,Notts County,Liverpool,2-2,2,2,1,1,4,0,D,"Watson, Tom",2,Away
488,1908-03-09,1907.0,Sheffield Wednesday,Liverpool,1-2,1,2,1,1,3,-1,A,"Watson, Tom",2,Away
489,1908-03-14,1907.0,Liverpool,Manchester City,0-1,0,1,1,1,1,-1,A,"Watson, Tom",0,Anfield
490,1908-03-21,1907.0,Preston North End,Liverpool,3-0,3,0,1,1,3,3,H,"Watson, Tom",0,Away
491,1908-03-25,1907.0,Liverpool,Manchester United,7-4,7,4,1,1,11,3,H,"Watson, Tom",7,Anfield
492,1908-03-28,1907.0,Bury,Liverpool,3-1,3,1,1,1,4,2,H,"Watson, Tom",1,Away
493,1908-04-04,1907.0,Aston Villa,Liverpool,5-1,5,1,1,1,6,4,H,"Watson, Tom",1,Away
494,1908-04-06,1907.0,Blackburn Rovers,Liverpool,1-3,1,3,1,1,4,-2,A,"Watson, Tom",3,Away
495,1908-04-11,1907.0,Newcastle United,Liverpool,3-1,3,1,1,1,4,2,H,"Watson, Tom",1,Away
496,1908-04-17,1907.0,Liverpool,Everton,0-0,0,0,1,1,0,0,D,"Watson, Tom",0,Anfield
497,1908-04-18,1907.0,Liverpool,Middlesbrough,0-1,0,1,1,1,1,-1,A,"Watson, Tom",0,Anfield
498,1908-04-20,1907.0,Chelsea,Liverpool,0-2,0,2,1,1,2,-2,A,"Watson, Tom",2,Away
499,1908-04-27,1907.0,Liverpool,Bury,2-1,2,1,1,1,3,1,H,"Watson, Tom",2,Anfield
500,1908-09-01,1908.0,Liverpool,Aston Villa,3-2,3,2,1,1,5,1,H,"Watson, Tom",3,Anfield
501,1908-09-05,1908.0,Liverpool,Chelsea,2-1,2,1,1,1,3,1,H,"Watson, Tom",2,Anfield
502,1908-09-12,1908.0,Blackburn Rovers,Liverpool,1-0,1,0,1,1,1,1,H,"Watson, Tom",0,Away
503,1908-09-14,1908.0,Sheffield United,Liverpool,0-2,0,2,1,1,2,-2,A,"Watson, Tom",2,Away
504,1908-09-19,1908.0,Liverpool,Bradford City,4-0,4,0,1,1,4,4,H,"Watson, Tom",4,Anfield
505,1908-09-26,1908.0,Manchester United,Liverpool,3-2,3,2,1,1,5,1,H,"Watson, Tom",2,Away
506,1908-10-01,1908.0,Nottingham Forest,Liverpool,5-1,5,1,1,1,6,4,H,"Watson, Tom",1,Away
507,1908-10-03,1908.0,Liverpool,Everton,0-1,0,1,1,1,1,-1,A,"Watson, Tom",0,Anfield
508,1908-10-10,1908.0,Leicester City,Liverpool,3-2,3,2,1,1,5,1,H,"Watson, Tom",2,Away
509,1908-10-17,1908.0,Liverpool,Arsenal,2-2,2,2,1,1,4,0,D,"Watson, Tom",2,Anfield
510,1908-10-24,1908.0,Notts County,Liverpool,1-2,1,2,1,1,3,-1,A,"Watson, Tom",2,Away
511,1908-10-31,1908.0,Liverpool,Newcastle United,2-1,2,1,1,1,3,1,H,"Watson, Tom",2,Anfield
512,1908-11-07,1908.0,Bristol City,Liverpool,1-0,1,0,1,1,1,1,H,"Watson, Tom",0,Away
513,1908-11-14,1908.0,Liverpool,Preston North End,2-1,2,1,1,1,3,1,H,"Watson, Tom",2,Anfield
514,1908-11-21,1908.0,Middlesbrough,Liverpool,1-0,1,0,1,1,1,1,H,"Watson, Tom",0,Away
515,1908-11-28,1908.0,Liverpool,Manchester City,1-3,1,3,1,1,4,-2,A,"Watson, Tom",1,Anfield
516,1908-12-05,1908.0,Sheffield Wednesday,Liverpool,2-3,2,3,1,1,5,-1,A,"Watson, Tom",3,Away
517,1908-12-12,1908.0,Bury,Liverpool,2-1,2,1,1,1,3,1,H,"Watson, Tom",1,Away
518,1908-12-19,1908.0,Liverpool,Sheffield United,2-1,2,1,1,1,3,1,H,"Watson, Tom",2,Anfield
519,1908-12-25,1908.0,Aston Villa,Liverpool,1-1,1,1,1,1,2,0,D,"Watson, Tom",1,Away
520,1908-12-26,1908.0,Liverpool,Nottingham Forest,1-1,1,1,1,1,2,0,D,"Watson, Tom",1,Anfield
521,1909-01-01,1908.0,Sunderland,Liverpool,1-4,1,4,1,1,5,-3,A,"Watson, Tom",4,Away
522,1909-01-02,1908.0,Chelsea,Liverpool,3-0,3,0,1,1,3,3,H,"Watson, Tom",0,Away
523,1909-01-09,1908.0,Liverpool,Blackburn Rovers,1-1,1,1,1,1,2,0,D,"Watson, Tom",1,Anfield
524,1909-01-23,1908.0,Bradford City,Liverpool,0-2,0,2,1,1,2,-2,A,"Watson, Tom",2,Away
525,1909-01-30,1908.0,Liverpool,Manchester United,3-1,3,1,1,1,4,2,H,"Watson, Tom",3,Anfield
526,1909-02-13,1908.0,Liverpool,Leicester City,4-1,4,1,1,1,5,3,H,"Watson, Tom",4,Anfield
527,1909-02-20,1908.0,Arsenal,Liverpool,5-0,5,0,1,1,5,5,H,"Watson, Tom",0,Away
528,1909-02-27,1908.0,Liverpool,Notts County,1-1,1,1,1,1,2,0,D,"Watson, Tom",1,Anfield
529,1909-03-13,1908.0,Liverpool,Bristol City,1-2,1,2,1,1,3,-1,A,"Watson, Tom",1,Anfield
530,1909-03-20,1908.0,Preston North End,Liverpool,2-0,2,0,1,1,2,2,H,"Watson, Tom",0,Away
531,1909-03-27,1908.0,Liverpool,Middlesbrough,1-2,1,2,1,1,3,-1,A,"Watson, Tom",1,Anfield
532,1909-04-03,1908.0,Manchester City,Liverpool,4-0,4,0,1,1,4,4,H,"Watson, Tom",0,Away
533,1909-04-09,1908.0,Everton,Liverpool,5-0,5,0,1,1,5,5,H,"Watson, Tom",0,Away
534,1909-04-10,1908.0,Liverpool,Sheffield Wednesday,1-2,1,2,1,1,3,-1,A,"Watson, Tom",1,Anfield
535,1909-04-12,1908.0,Liverpool,Sunderland,3-0,3,0,1,1,3,3,H,"Watson, Tom",3,Anfield
536,1909-04-17,1908.0,Liverpool,Bury,2-2,2,2,1,1,4,0,D,"Watson, Tom",2,Anfield
537,1909-04-30,1908.0,Newcastle United,Liverpool,0-1,0,1,1,1,1,-1,A,"Watson, Tom",1,Away
538,1909-09-04,1909.0,Chelsea,Liverpool,2-1,2,1,1,1,3,1,H,"Watson, Tom",1,Away
539,1909-09-06,1909.0,Bolton Wanderers,Liverpool,1-2,1,2,1,1,3,-1,A,"Watson, Tom",2,Away
540,1909-09-11,1909.0,Liverpool,Blackburn Rovers,3-1,3,1,1,1,4,2,H,"Watson, Tom",3,Anfield
541,1909-09-18,1909.0,Nottingham Forest,Liverpool,1-4,1,4,1,1,5,-3,A,"Watson, Tom",4,Away
542,1909-09-25,1909.0,Liverpool,Sunderland,1-4,1,4,1,1,5,-3,A,"Watson, Tom",1,Anfield
543,1909-10-02,1909.0,Everton,Liverpool,2-3,2,3,1,1,5,-1,A,"Watson, Tom",3,Away
544,1909-10-09,1909.0,Liverpool,Manchester United,3-2,3,2,1,1,5,1,H,"Watson, Tom",3,Anfield
545,1909-10-16,1909.0,Bradford City,Liverpool,1-2,1,2,1,1,3,-1,A,"Watson, Tom",2,Away
546,1909-10-23,1909.0,Liverpool,Sheffield Wednesday,3-1,3,1,1,1,4,2,H,"Watson, Tom",3,Anfield
547,1909-10-30,1909.0,Bristol City,Liverpool,0-1,0,1,1,1,1,-1,A,"Watson, Tom",1,Away
548,1909-11-06,1909.0,Liverpool,Bury,2-2,2,2,1,1,4,0,D,"Watson, Tom",2,Anfield
549,1909-11-13,1909.0,Tottenham Hotspur,Liverpool,1-0,1,0,1,1,1,1,H,"Watson, Tom",0,Away
550,1909-11-20,1909.0,Liverpool,Preston North End,2-0,2,0,1,1,2,2,H,"Watson, Tom",2,Anfield
551,1909-11-27,1909.0,Notts County,Liverpool,3-1,3,1,1,1,4,2,H,"Watson, Tom",1,Away
552,1909-12-04,1909.0,Liverpool,Newcastle United,6-5,6,5,1,1,11,1,H,"Watson, Tom",6,Anfield
553,1909-12-11,1909.0,Liverpool,Middlesbrough,0-0,0,0,1,1,0,0,D,"Watson, Tom",0,Anfield
554,1909-12-18,1909.0,Aston Villa,Liverpool,3-1,3,1,1,1,4,2,H,"Watson, Tom",1,Away
555,1909-12-25,1909.0,Liverpool,Bolton Wanderers,3-0,3,0,1,1,3,3,H,"Watson, Tom",3,Anfield
556,1909-12-27,1909.0,Arsenal,Liverpool,1-1,1,1,1,1,2,0,D,"Watson, Tom",1,Away
557,1909-12-28,1909.0,Sheffield United,Liverpool,4-2,4,2,1,1,6,2,H,"Watson, Tom",2,Away
558,1910-01-01,1909.0,Liverpool,Arsenal,5-1,5,1,1,1,6,4,H,"Watson, Tom",5,Anfield
559,1910-01-08,1909.0,Liverpool,Chelsea,5-1,5,1,1,1,6,4,H,"Watson, Tom",5,Anfield
560,1910-01-22,1909.0,Blackburn Rovers,Liverpool,1-1,1,1,1,1,2,0,D,"Watson, Tom",1,Away
561,1910-02-12,1909.0,Liverpool,Everton,0-1,0,1,1,1,1,-1,A,"Watson, Tom",0,Anfield
562,1910-02-19,1909.0,Manchester United,Liverpool,3-4,3,4,1,1,7,-1,A,"Watson, Tom",4,Away
563,1910-02-26,1909.0,Liverpool,Bradford City,1-0,1,0,1,1,1,1,H,"Watson, Tom",1,Anfield
564,1910-03-05,1909.0,Sheffield Wednesday,Liverpool,3-0,3,0,1,1,3,3,H,"Watson, Tom",0,Away
565,1910-03-12,1909.0,Liverpool,Bristol City,0-1,0,1,1,1,1,-1,A,"Watson, Tom",0,Anfield
566,1910-03-19,1909.0,Bury,Liverpool,1-2,1,2,1,1,3,-1,A,"Watson, Tom",2,Away
567,1910-03-25,1909.0,Liverpool,Sheffield United,0-0,0,0,1,1,0,0,D,"Watson, Tom",0,Anfield
568,1910-03-26,1909.0,Liverpool,Tottenham Hotspur,2-0,2,0,1,1,2,2,H,"Watson, Tom",2,Anfield
569,1910-03-28,1909.0,Sunderland,Liverpool,2-1,2,1,1,1,3,1,H,"Watson, Tom",1,Away
570,1910-04-02,1909.0,Preston North End,Liverpool,2-0,2,0,1,1,2,2,H,"Watson, Tom",0,Away
571,1910-04-09,1909.0,Liverpool,Notts County,2-1,2,1,1,1,3,1,H,"Watson, Tom",2,Anfield
572,1910-04-16,1909.0,Newcastle United,Liverpool,1-3,1,3,1,1,4,-2,A,"Watson, Tom",3,Away
573,1910-04-20,1909.0,Liverpool,Nottingham Forest,7-3,7,3,1,1,10,4,H,"Watson, Tom",7,Anfield
574,1910-04-23,1909.0,Middlesbrough,Liverpool,2-2,2,2,1,1,4,0,D,"Watson, Tom",2,Away
575,1910-04-30,1909.0,Liverpool,Aston Villa,2-0,2,0,1,1,2,2,H,"Watson, Tom",2,Anfield
576,1910-09-03,1910.0,Liverpool,Bradford City,1-2,1,2,1,1,3,-1,A,"Watson, Tom",1,Anfield
577,1910-09-10,1910.0,Blackburn Rovers,Liverpool,1-2,1,2,1,1,3,-1,A,"Watson, Tom",2,Away
578,1910-09-17,1910.0,Liverpool,Nottingham Forest,2-3,2,3,1,1,5,-1,A,"Watson, Tom",2,Anfield
579,1910-09-19,1910.0,Sheffield United,Liverpool,2-0,2,0,1,1,2,2,H,"Watson, Tom",0,Away
580,1910-09-24,1910.0,Manchester City,Liverpool,1-2,1,2,1,1,3,-1,A,"Watson, Tom",2,Away
581,1910-10-01,1910.0,Liverpool,Everton,0-2,0,2,1,1,2,-2,A,"Watson, Tom",0,Anfield
582,1910-10-08,1910.0,Sheffield Wednesday,Liverpool,1-0,1,0,1,1,1,1,H,"Watson, Tom",0,Away
583,1910-10-15,1910.0,Liverpool,Bristol City,4-0,4,0,1,1,4,4,H,"Watson, Tom",4,Anfield
584,1910-10-22,1910.0,Newcastle United,Liverpool,6-1,6,1,1,1,7,5,H,"Watson, Tom",1,Away
585,1910-10-29,1910.0,Liverpool,Tottenham Hotspur,1-2,1,2,1,1,3,-1,A,"Watson, Tom",1,Anfield
586,1910-11-05,1910.0,Middlesbrough,Liverpool,2-2,2,2,1,1,4,0,D,"Watson, Tom",2,Away
587,1910-11-12,1910.0,Liverpool,Preston North End,3-0,3,0,1,1,3,3,H,"Watson, Tom",3,Anfield
588,1910-11-19,1910.0,Notts County,Liverpool,1-0,1,0,1,1,1,1,H,"Watson, Tom",0,Away
589,1910-11-26,1910.0,Liverpool,Manchester United,3-2,3,2,1,1,5,1,H,"Watson, Tom",3,Anfield
590,1910-12-03,1910.0,Oldham Athletic,Liverpool,3-1,3,1,1,1,4,2,H,"Watson, Tom",1,Away
591,1910-12-10,1910.0,Bury,Liverpool,3-0,3,0,1,1,3,3,H,"Watson, Tom",0,Away
592,1910-12-17,1910.0,Liverpool,Sheffield United,2-0,2,0,1,1,2,2,H,"Watson, Tom",2,Anfield
593,1910-12-24,1910.0,Aston Villa,Liverpool,1-1,1,1,1,1,2,0,D,"Watson, Tom",1,Away
594,1910-12-26,1910.0,Liverpool,Sunderland,1-2,1,2,1,1,3,-1,A,"Watson, Tom",1,Anfield
595,1910-12-27,1910.0,Everton,Liverpool,0-1,0,1,1,1,1,-1,A,"Watson, Tom",1,Away
596,1910-12-31,1910.0,Bradford City,Liverpool,1-3,1,3,1,1,4,-2,A,"Watson, Tom",3,Away
597,1911-01-02,1910.0,Sunderland,Liverpool,4-0,4,0,1,1,4,4,H,"Watson, Tom",0,Away
598,1911-01-07,1910.0,Liverpool,Blackburn Rovers,2-2,2,2,1,1,4,0,D,"Watson, Tom",2,Anfield
599,1911-01-21,1910.0,Nottingham Forest,Liverpool,2-0,2,0,1,1,2,2,H,"Watson, Tom",0,Away
600,1911-01-28,1910.0,Liverpool,Manchester City,1-1,1,1,1,1,2,0,D,"Watson, Tom",1,Anfield
601,1911-02-11,1910.0,Liverpool,Sheffield Wednesday,3-0,3,0,1,1,3,3,H,"Watson, Tom",3,Anfield
602,1911-02-18,1910.0,Bristol City,Liverpool,1-1,1,1,1,1,2,0,D,"Watson, Tom",1,Away
603,1911-02-27,1910.0,Liverpool,Newcastle United,3-0,3,0,1,1,3,3,H,"Watson, Tom",3,Anfield
604,1911-03-04,1910.0,Tottenham Hotspur,Liverpool,1-0,1,0,1,1,1,1,H,"Watson, Tom",0,Away
605,1911-03-11,1910.0,Liverpool,Middlesbrough,3-0,3,0,1,1,3,3,H,"Watson, Tom",3,Anfield
606,1911-03-18,1910.0,Preston North End,Liverpool,2-1,2,1,1,1,3,1,H,"Watson, Tom",1,Away
607,1911-03-25,1910.0,Liverpool,Notts County,2-1,2,1,1,1,3,1,H,"Watson, Tom",2,Anfield
608,1911-04-01,1910.0,Manchester United,Liverpool,2-0,2,0,1,1,2,2,H,"Watson, Tom",0,Away
609,1911-04-08,1910.0,Liverpool,Oldham Athletic,1-0,1,0,1,1,1,1,H,"Watson, Tom",1,Anfield
610,1911-04-14,1910.0,Arsenal,Liverpool,0-0,0,0,1,1,0,0,D,"Watson, Tom",0,Away
611,1911-04-15,1910.0,Liverpool,Bury,2-0,2,0,1,1,2,2,H,"Watson, Tom",2,Anfield
612,1911-04-17,1910.0,Liverpool,Arsenal,1-1,1,1,1,1,2,0,D,"Watson, Tom",1,Anfield
613,1911-04-29,1910.0,Liverpool,Aston Villa,3-1,3,1,1,1,4,2,H,"Watson, Tom",3,Anfield
614,1911-09-02,1911.0,Arsenal,Liverpool,2-2,2,2,1,1,4,0,D,"Watson, Tom",2,Away
615,1911-09-04,1911.0,Bolton Wanderers,Liverpool,2-1,2,1,1,1,3,1,H,"Watson, Tom",1,Away
616,1911-09-09,1911.0,Liverpool,Manchester City,2-2,2,2,1,1,4,0,D,"Watson, Tom",2,Anfield
617,1911-09-16,1911.0,Everton,Liverpool,2-1,2,1,1,1,3,1,H,"Watson, Tom",1,Away
618,1911-09-23,1911.0,Liverpool,West Bromwich Albion,1-3,1,3,1,1,4,-2,A,"Watson, Tom",1,Anfield
619,1911-09-30,1911.0,Sunderland,Liverpool,1-2,1,2,1,1,3,-1,A,"Watson, Tom",2,Away
620,1911-10-07,1911.0,Liverpool,Blackburn Rovers,1-2,1,2,1,1,3,-1,A,"Watson, Tom",1,Anfield
621,1911-10-14,1911.0,Sheffield Wednesday,Liverpool,2-2,2,2,1,1,4,0,D,"Watson, Tom",2,Away
622,1911-10-21,1911.0,Liverpool,Bury,1-1,1,1,1,1,2,0,D,"Watson, Tom",1,Anfield
623,1911-10-28,1911.0,Middlesbrough,Liverpool,3-2,3,2,1,1,5,1,H,"Watson, Tom",2,Away
624,1911-11-04,1911.0,Liverpool,Notts County,3-0,3,0,1,1,3,3,H,"Watson, Tom",3,Anfield
625,1911-11-11,1911.0,Tottenham Hotspur,Liverpool,2-0,2,0,1,1,2,2,H,"Watson, Tom",0,Away
626,1911-11-18,1911.0,Liverpool,Manchester United,3-2,3,2,1,1,5,1,H,"Watson, Tom",3,Anfield
627,1911-11-25,1911.0,Liverpool,Preston North End,0-1,0,1,1,1,1,-1,A,"Watson, Tom",0,Anfield
628,1911-12-02,1911.0,Aston Villa,Liverpool,5-0,5,0,1,1,5,5,H,"Watson, Tom",0,Away
629,1911-12-09,1911.0,Liverpool,Newcastle United,0-1,0,1,1,1,1,-1,A,"Watson, Tom",0,Anfield
630,1911-12-16,1911.0,Sheffield United,Liverpool,3-1,3,1,1,1,4,2,H,"Watson, Tom",1,Away
631,1911-12-23,1911.0,Liverpool,Oldham Athletic,1-0,1,0,1,1,1,1,H,"Watson, Tom",1,Anfield
632,1911-12-25,1911.0,Liverpool,Bolton Wanderers,1-0,1,0,1,1,1,1,H,"Watson, Tom",1,Anfield
633,1911-12-30,1911.0,Liverpool,Arsenal,4-1,4,1,1,1,5,3,H,"Watson, Tom",4,Anfield
634,1912-01-01,1911.0,Liverpool,Bradford City,1-0,1,0,1,1,1,1,H,"Watson, Tom",1,Anfield
635,1912-01-06,1911.0,Manchester City,Liverpool,2-3,2,3,1,1,5,-1,A,"Watson, Tom",3,Away
636,1912-01-20,1911.0,Liverpool,Everton,1-3,1,3,1,1,4,-2,A,"Watson, Tom",1,Anfield
637,1912-01-27,1911.0,West Bromwich Albion,Liverpool,1-0,1,0,1,1,1,1,H,"Watson, Tom",0,Away
638,1912-02-10,1911.0,Blackburn Rovers,Liverpool,1-0,1,0,1,1,1,1,H,"Watson, Tom",0,Away
639,1912-02-17,1911.0,Liverpool,Sheffield Wednesday,1-1,1,1,1,1,2,0,D,"Watson, Tom",1,Anfield
640,1912-02-24,1911.0,Bury,Liverpool,2-2,2,2,1,1,4,0,D,"Watson, Tom",2,Away
641,1912-03-02,1911.0,Liverpool,Middlesbrough,1-1,1,1,1,1,2,0,D,"Watson, Tom",1,Anfield
642,1912-03-09,1911.0,Notts County,Liverpool,0-0,0,0,1,1,0,0,D,"Watson, Tom",0,Away
643,1912-03-16,1911.0,Liverpool,Tottenham Hotspur,1-2,1,2,1,1,3,-1,A,"Watson, Tom",1,Anfield
644,1912-03-23,1911.0,Manchester United,Liverpool,1-1,1,1,1,1,2,0,D,"Watson, Tom",1,Away
645,1912-03-30,1911.0,Preston North End,Liverpool,2-1,2,1,1,1,3,1,H,"Watson, Tom",1,Away
646,1912-04-05,1911.0,Liverpool,Sunderland,2-1,2,1,1,1,3,1,H,"Watson, Tom",2,Anfield
647,1912-04-06,1911.0,Liverpool,Aston Villa,1-2,1,2,1,1,3,-1,A,"Watson, Tom",1,Anfield
648,1912-04-08,1911.0,Bradford City,Liverpool,0-2,0,2,1,1,2,-2,A,"Watson, Tom",2,Away
649,1912-04-13,1911.0,Newcastle United,Liverpool,1-1,1,1,1,1,2,0,D,"Watson, Tom",1,Away
650,1912-04-20,1911.0,Liverpool,Sheffield United,2-0,2,0,1,1,2,2,H,"Watson, Tom",2,Anfield
651,1912-04-27,1911.0,Oldham Athletic,Liverpool,0-1,0,1,1,1,1,-1,A,"Watson, Tom",1,Away
652,1912-09-04,1912.0,Liverpool,Oldham Athletic,2-0,2,0,1,1,2,2,H,"Watson, Tom",2,Anfield
653,1912-09-07,1912.0,Liverpool,Arsenal,3-0,3,0,1,1,3,3,H,"Watson, Tom",3,Anfield
654,1912-09-09,1912.0,Chelsea,Liverpool,1-2,1,2,1,1,3,-1,A,"Watson, Tom",2,Away
655,1912-09-14,1912.0,Bradford City,Liverpool,2-0,2,0,1,1,2,2,H,"Watson, Tom",0,Away
656,1912-09-21,1912.0,Liverpool,Manchester City,1-2,1,2,1,1,3,-1,A,"Watson, Tom",1,Anfield
657,1912-09-28,1912.0,West Bromwich Albion,Liverpool,3-1,3,1,1,1,4,2,H,"Watson, Tom",1,Away
658,1912-10-05,1912.0,Liverpool,Everton,0-2,0,2,1,1,2,-2,A,"Watson, Tom",0,Anfield
659,1912-10-12,1912.0,Sheffield Wednesday,Liverpool,1-0,1,0,1,1,1,1,H,"Watson, Tom",0,Away
660,1912-10-14,1912.0,Sheffield United,Liverpool,4-1,4,1,1,1,5,3,H,"Watson, Tom",1,Away
661,1912-10-19,1912.0,Liverpool,Blackburn Rovers,4-1,4,1,1,1,5,3,H,"Watson, Tom",4,Anfield
662,1912-10-26,1912.0,Derby County,Liverpool,4-2,4,2,1,1,6,2,H,"Watson, Tom",2,Away
663,1912-11-02,1912.0,Liverpool,Tottenham Hotspur,4-1,4,1,1,1,5,3,H,"Watson, Tom",4,Anfield
664,1912-11-09,1912.0,Middlesbrough,Liverpool,3-4,3,4,1,1,7,-1,A,"Watson, Tom",4,Away
665,1912-11-16,1912.0,Liverpool,Notts County,0-0,0,0,1,1,0,0,D,"Watson, Tom",0,Anfield
666,1912-11-23,1912.0,Manchester United,Liverpool,3-1,3,1,1,1,4,2,H,"Watson, Tom",1,Away
667,1912-11-30,1912.0,Liverpool,Aston Villa,2-0,2,0,1,1,2,2,H,"Watson, Tom",2,Anfield
668,1912-12-07,1912.0,Sunderland,Liverpool,7-0,7,0,1,1,7,7,H,"Watson, Tom",0,Away
669,1912-12-14,1912.0,Bolton Wanderers,Liverpool,1-1,1,1,1,1,2,0,D,"Watson, Tom",1,Away
670,1912-12-21,1912.0,Liverpool,Sheffield United,2-2,2,2,1,1,4,0,D,"Watson, Tom",2,Anfield
671,1912-12-26,1912.0,Liverpool,Newcastle United,2-1,2,1,1,1,3,1,H,"Watson, Tom",2,Anfield
672,1912-12-28,1912.0,Arsenal,Liverpool,1-1,1,1,1,1,2,0,D,"Watson, Tom",1,Away
673,1913-01-01,1912.0,Newcastle United,Liverpool,0-0,0,0,1,1,0,0,D,"Watson, Tom",0,Away
674,1913-01-04,1912.0,Liverpool,Bradford City,2-1,2,1,1,1,3,1,H,"Watson, Tom",2,Anfield
675,1913-01-18,1912.0,Manchester City,Liverpool,4-1,4,1,1,1,5,3,H,"Watson, Tom",1,Away
676,1913-01-25,1912.0,Liverpool,West Bromwich Albion,2-1,2,1,1,1,3,1,H,"Watson, Tom",2,Anfield
677,1913-02-08,1912.0,Everton,Liverpool,0-2,0,2,1,1,2,-2,A,"Watson, Tom",2,Away
678,1913-02-10,1912.0,Oldham Athletic,Liverpool,3-1,3,1,1,1,4,2,H,"Watson, Tom",1,Away
679,1913-02-15,1912.0,Liverpool,Sheffield Wednesday,2-1,2,1,1,1,3,1,H,"Watson, Tom",2,Anfield
680,1913-03-01,1912.0,Liverpool,Derby County,2-1,2,1,1,1,3,1,H,"Watson, Tom",2,Anfield
681,1913-03-08,1912.0,Tottenham Hotspur,Liverpool,1-0,1,0,1,1,1,1,H,"Watson, Tom",0,Away
682,1913-03-10,1912.0,Blackburn Rovers,Liverpool,5-1,5,1,1,1,6,4,H,"Watson, Tom",1,Away
683,1913-03-15,1912.0,Liverpool,Middlesbrough,4-2,4,2,1,1,6,2,H,"Watson, Tom",4,Anfield
684,1913-03-22,1912.0,Notts County,Liverpool,3-0,3,0,1,1,3,3,H,"Watson, Tom",0,Away
685,1913-03-24,1912.0,Liverpool,Chelsea,1-2,1,2,1,1,3,-1,A,"Watson, Tom",1,Anfield
686,1913-03-29,1912.0,Liverpool,Manchester United,0-2,0,2,1,1,2,-2,A,"Watson, Tom",0,Anfield
687,1913-04-05,1912.0,Aston Villa,Liverpool,1-3,1,3,1,1,4,-2,A,"Watson, Tom",3,Away
688,1913-04-12,1912.0,Liverpool,Sunderland,2-5,2,5,1,1,7,-3,A,"Watson, Tom",2,Anfield
689,1913-04-19,1912.0,Liverpool,Bolton Wanderers,5-0,5,0,1,1,5,5,H,"Watson, Tom",5,Anfield
690,1913-09-01,1913.0,Derby County,Liverpool,1-1,1,1,1,1,2,0,D,"Watson, Tom",1,Away
691,1913-09-06,1913.0,Blackburn Rovers,Liverpool,6-2,6,2,1,1,8,4,H,"Watson, Tom",2,Away
692,1913-09-13,1913.0,Liverpool,Sunderland,1-3,1,3,1,1,4,-2,A,"Watson, Tom",1,Anfield
693,1913-09-20,1913.0,Everton,Liverpool,1-2,1,2,1,1,3,-1,A,"Watson, Tom",2,Away
694,1913-09-27,1913.0,Liverpool,West Bromwich Albion,0-0,0,0,1,1,0,0,D,"Watson, Tom",0,Anfield
695,1913-10-04,1913.0,Sheffield Wednesday,Liverpool,4-1,4,1,1,1,5,3,H,"Watson, Tom",1,Away
696,1913-10-11,1913.0,Liverpool,Bolton Wanderers,2-1,2,1,1,1,3,1,H,"Watson, Tom",2,Anfield
697,1913-10-18,1913.0,Chelsea,Liverpool,3-0,3,0,1,1,3,3,H,"Watson, Tom",0,Away
698,1913-10-25,1913.0,Liverpool,Oldham Athletic,0-3,0,3,1,1,3,-3,A,"Watson, Tom",0,Anfield
699,1913-11-01,1913.0,Manchester United,Liverpool,3-0,3,0,1,1,3,3,H,"Watson, Tom",0,Away
700,1913-11-08,1913.0,Liverpool,Burnley,1-1,1,1,1,1,2,0,D,"Watson, Tom",1,Anfield
701,1913-11-15,1913.0,Preston North End,Liverpool,0-1,0,1,1,1,1,-1,A,"Watson, Tom",1,Away
702,1913-11-22,1913.0,Liverpool,Newcastle United,0-0,0,0,1,1,0,0,D,"Watson, Tom",0,Anfield
703,1913-11-29,1913.0,Liverpool,Tottenham Hotspur,2-1,2,1,1,1,3,1,H,"Watson, Tom",2,Anfield
704,1913-12-06,1913.0,Aston Villa,Liverpool,2-1,2,1,1,1,3,1,H,"Watson, Tom",1,Away
705,1913-12-13,1913.0,Liverpool,Middlesbrough,2-1,2,1,1,1,3,1,H,"Watson, Tom",2,Anfield
706,1913-12-20,1913.0,Sheffield United,Liverpool,0-1,0,1,1,1,1,-1,A,"Watson, Tom",1,Away
707,1913-12-25,1913.0,Liverpool,Manchester City,4-2,4,2,1,1,6,2,H,"Watson, Tom",4,Anfield
708,1913-12-26,1913.0,Manchester City,Liverpool,1-0,1,0,1,1,1,1,H,"Watson, Tom",0,Away
709,1913-12-27,1913.0,Liverpool,Blackburn Rovers,3-3,3,3,1,1,6,0,D,"Watson, Tom",3,Anfield
710,1914-01-01,1913.0,Liverpool,Bradford City,0-1,0,1,1,1,1,-1,A,"Watson, Tom",0,Anfield
711,1914-01-03,1913.0,Sunderland,Liverpool,1-2,1,2,1,1,3,-1,A,"Watson, Tom",2,Away
712,1914-01-17,1913.0,Liverpool,Everton,1-2,1,2,1,1,3,-1,A,"Watson, Tom",1,Anfield
713,1914-01-24,1913.0,West Bromwich Albion,Liverpool,0-1,0,1,1,1,1,-1,A,"Watson, Tom",1,Away
714,1914-02-07,1913.0,Liverpool,Sheffield Wednesday,1-2,1,2,1,1,3,-1,A,"Watson, Tom",1,Anfield
715,1914-02-14,1913.0,Bolton Wanderers,Liverpool,2-1,2,1,1,1,3,1,H,"Watson, Tom",1,Away
716,1914-02-28,1913.0,Oldham Athletic,Liverpool,2-2,2,2,1,1,4,0,D,"Watson, Tom",2,Away
717,1914-03-14,1913.0,Burnley,Liverpool,5-2,5,2,1,1,7,3,H,"Watson, Tom",2,Away
718,1914-03-18,1913.0,Liverpool,Chelsea,3-0,3,0,1,1,3,3,H,"Watson, Tom",3,Anfield
719,1914-03-21,1913.0,Liverpool,Preston North End,3-1,3,1,1,1,4,2,H,"Watson, Tom",3,Anfield
720,1914-04-01,1913.0,Newcastle United,Liverpool,1-2,1,2,1,1,3,-1,A,"Watson, Tom",2,Away
721,1914-04-04,1913.0,Tottenham Hotspur,Liverpool,0-0,0,0,1,1,0,0,D,"Watson, Tom",0,Away
722,1914-04-10,1913.0,Liverpool,Derby County,1-0,1,0,1,1,1,1,H,"Watson, Tom",1,Anfield
723,1914-04-11,1913.0,Liverpool,Aston Villa,0-1,0,1,1,1,1,-1,A,"Watson, Tom",0,Anfield
724,1914-04-13,1913.0,Bradford City,Liverpool,1-0,1,0,1,1,1,1,H,"Watson, Tom",0,Away
725,1914-04-15,1913.0,Liverpool,Manchester United,1-2,1,2,1,1,3,-1,A,"Watson, Tom",1,Anfield
726,1914-04-18,1913.0,Middlesbrough,Liverpool,4-0,4,0,1,1,4,4,H,"Watson, Tom",0,Away
727,1914-04-27,1913.0,Liverpool,Sheffield United,2-1,2,1,1,1,3,1,H,"Watson, Tom",2,Anfield
728,1914-09-02,1914.0,Liverpool,Bolton Wanderers,4-3,4,3,1,1,7,1,H,"Watson, Tom",4,Anfield
729,1914-09-05,1914.0,Liverpool,Notts County,1-1,1,1,1,1,2,0,D,"Watson, Tom",1,Anfield
730,1914-09-12,1914.0,Sunderland,Liverpool,2-2,2,2,1,1,4,0,D,"Watson, Tom",2,Away
731,1914-09-19,1914.0,Liverpool,Sheffield Wednesday,2-1,2,1,1,1,3,1,H,"Watson, Tom",2,Anfield
732,1914-09-21,1914.0,Blackburn Rovers,Liverpool,4-2,4,2,1,1,6,2,H,"Watson, Tom",2,Away
733,1914-09-26,1914.0,West Bromwich Albion,Liverpool,4-0,4,0,1,1,4,4,H,"Watson, Tom",0,Away
734,1914-10-03,1914.0,Liverpool,Everton,0-5,0,5,1,1,5,-5,A,"Watson, Tom",0,Anfield
735,1914-10-10,1914.0,Chelsea,Liverpool,3-1,3,1,1,1,4,2,H,"Watson, Tom",1,Away
736,1914-10-17,1914.0,Liverpool,Bradford City,2-1,2,1,1,1,3,1,H,"Watson, Tom",2,Anfield
737,1914-10-24,1914.0,Burnley,Liverpool,3-0,3,0,1,1,3,3,H,"Watson, Tom",0,Away
738,1914-10-31,1914.0,Liverpool,Tottenham Hotspur,7-2,7,2,1,1,9,5,H,"Watson, Tom",7,Anfield
739,1914-11-07,1914.0,Newcastle United,Liverpool,0-0,0,0,1,1,0,0,D,"Watson, Tom",0,Away
740,1914-11-14,1914.0,Liverpool,Middlesbrough,1-1,1,1,1,1,2,0,D,"Watson, Tom",1,Anfield
741,1914-11-21,1914.0,Sheffield United,Liverpool,2-1,2,1,1,1,3,1,H,"Watson, Tom",1,Away
742,1914-11-28,1914.0,Liverpool,Aston Villa,3-6,3,6,1,1,9,-3,A,"Watson, Tom",3,Anfield
743,1914-12-05,1914.0,Manchester City,Liverpool,1-1,1,1,1,1,2,0,D,"Watson, Tom",1,Away
744,1914-12-12,1914.0,Bradford Park Avenue,Liverpool,1-0,1,0,1,1,1,1,H,"Watson, Tom",0,Away
745,1914-12-19,1914.0,Liverpool,Oldham Athletic,1-2,1,2,1,1,3,-1,A,"Watson, Tom",1,Anfield
746,1914-12-25,1914.0,Bolton Wanderers,Liverpool,0-1,0,1,1,1,1,-1,A,"Watson, Tom",1,Away
747,1914-12-26,1914.0,Liverpool,Manchester United,1-1,1,1,1,1,2,0,D,"Watson, Tom",1,Anfield
748,1915-01-02,1914.0,Notts County,Liverpool,3-1,3,1,1,1,4,2,H,"Watson, Tom",1,Away
749,1915-01-16,1914.0,Liverpool,Sunderland,2-1,2,1,1,1,3,1,H,"Watson, Tom",2,Anfield
750,1915-01-23,1914.0,Sheffield Wednesday,Liverpool,2-1,2,1,1,1,3,1,H,"Watson, Tom",1,Away
751,1915-02-06,1914.0,Everton,Liverpool,1-3,1,3,1,1,4,-2,A,"Watson, Tom",3,Away
752,1915-02-13,1914.0,Liverpool,Chelsea,3-3,3,3,1,1,6,0,D,"Watson, Tom",3,Anfield
753,1915-02-27,1914.0,Liverpool,Burnley,3-0,3,0,1,1,3,3,H,"Watson, Tom",3,Anfield
754,1915-03-06,1914.0,Tottenham Hotspur,Liverpool,1-1,1,1,1,1,2,0,D,"Watson, Tom",1,Away
755,1915-03-10,1914.0,Bradford City,Liverpool,3-2,3,2,1,1,5,1,H,"Watson, Tom",2,Away
756,1915-03-13,1914.0,Liverpool,Manchester City,3-2,3,2,1,1,5,1,H,"Watson, Tom",3,Anfield
757,1915-03-20,1914.0,Middlesbrough,Liverpool,3-0,3,0,1,1,3,3,H,"Watson, Tom",0,Away
758,1915-03-24,1914.0,Liverpool,West Bromwich Albion,3-1,3,1,1,1,4,2,H,"Watson, Tom",3,Anfield
759,1915-03-29,1914.0,Liverpool,Newcastle United,2-2,2,2,1,1,4,0,D,"Watson, Tom",2,Anfield
760,1915-04-02,1914.0,Manchester United,Liverpool,2-0,2,0,1,1,2,2,H,"Watson, Tom",0,Away
761,1915-04-03,1914.0,Aston Villa,Liverpool,6-2,6,2,1,1,8,4,H,"Watson, Tom",2,Away
762,1915-04-05,1914.0,Liverpool,Blackburn Rovers,3-0,3,0,1,1,3,3,H,"Watson, Tom",3,Anfield
763,1915-04-12,1914.0,Liverpool,Sheffield United,2-1,2,1,1,1,3,1,H,"Watson, Tom",2,Anfield
764,1915-04-17,1914.0,Liverpool,Bradford Park Avenue,2-1,2,1,1,1,3,1,H,"Watson, Tom",2,Anfield
765,1915-04-24,1914.0,Oldham Athletic,Liverpool,0-2,0,2,1,1,2,-2,A,"Watson, Tom",2,Away
766,1919-08-30,1919.0,Bradford City,Liverpool,1-3,1,3,1,1,4,-2,A,"Patterson, George",3,Away
767,1919-09-01,1919.0,Liverpool,Arsenal,2-3,2,3,1,1,5,-1,A,"Patterson, George",2,Anfield
768,1919-09-06,1919.0,Liverpool,Bradford City,2-1,2,1,1,1,3,1,H,"Patterson, George",2,Anfield
769,1919-09-08,1919.0,Arsenal,Liverpool,1-0,1,0,1,1,1,1,H,"Patterson, George",0,Away
770,1919-09-13,1919.0,Liverpool,Aston Villa,2-1,2,1,1,1,3,1,H,"Patterson, George",2,Anfield
771,1919-09-20,1919.0,Aston Villa,Liverpool,0-1,0,1,1,1,1,-1,A,"Patterson, George",1,Away
772,1919-09-27,1919.0,Liverpool,Newcastle United,1-1,1,1,1,1,2,0,D,"Patterson, George",1,Anfield
773,1919-10-04,1919.0,Newcastle United,Liverpool,3-0,3,0,1,1,3,3,H,"Patterson, George",0,Away
774,1919-10-11,1919.0,Chelsea,Liverpool,1-0,1,0,1,1,1,1,H,"Patterson, George",0,Away
775,1919-10-18,1919.0,Liverpool,Chelsea,0-1,0,1,1,1,1,-1,A,"Patterson, George",0,Anfield
776,1919-10-25,1919.0,Burnley,Liverpool,1-2,1,2,1,1,3,-1,A,"Patterson, George",2,Away
777,1919-11-01,1919.0,Liverpool,Burnley,0-1,0,1,1,1,1,-1,A,"Patterson, George",0,Anfield
778,1919-11-08,1919.0,Bradford Park Avenue,Liverpool,1-2,1,2,1,1,3,-1,A,"Patterson, George",2,Away
779,1919-11-15,1919.0,Liverpool,Bradford Park Avenue,3-3,3,3,1,1,6,0,D,"Patterson, George",3,Anfield
780,1919-11-22,1919.0,Preston North End,Liverpool,2-1,2,1,1,1,3,1,H,"Patterson, George",1,Away
781,1919-11-29,1919.0,Liverpool,Preston North End,1-2,1,2,1,1,3,-1,A,"Patterson, George",1,Anfield
782,1919-12-06,1919.0,Middlesbrough,Liverpool,3-2,3,2,1,1,5,1,H,"Patterson, George",2,Away
783,1919-12-13,1919.0,Liverpool,Middlesbrough,1-0,1,0,1,1,1,1,H,"Patterson, George",1,Anfield
784,1919-12-20,1919.0,Everton,Liverpool,0-0,0,0,1,1,0,0,D,"Ashworth, David",0,Away
785,1919-12-25,1919.0,Liverpool,Sunderland,3-2,3,2,1,1,5,1,H,"Ashworth, David",3,Anfield
786,1919-12-26,1919.0,Manchester United,Liverpool,0-0,0,0,1,1,0,0,D,"Ashworth, David",0,Away
787,1919-12-27,1919.0,Liverpool,Everton,3-1,3,1,1,1,4,2,H,"Ashworth, David",3,Anfield
788,1920-01-01,1919.0,Liverpool,Manchester United,0-0,0,0,1,1,0,0,D,"Ashworth, David",0,Anfield
789,1920-01-03,1919.0,Sheffield United,Liverpool,3-2,3,2,1,1,5,1,H,"Ashworth, David",2,Away
790,1920-01-17,1919.0,Liverpool,Sheffield United,2-0,2,0,1,1,2,2,H,"Ashworth, David",2,Anfield
791,1920-01-24,1919.0,Bolton Wanderers,Liverpool,0-3,0,3,1,1,3,-3,A,"Ashworth, David",3,Away
792,1920-02-04,1919.0,Liverpool,Bolton Wanderers,2-0,2,0,1,1,2,2,H,"Ashworth, David",2,Anfield
793,1920-02-07,1919.0,Blackburn Rovers,Liverpool,0-2,0,2,1,1,2,-2,A,"Ashworth, David",2,Away
794,1920-02-14,1919.0,Liverpool,Blackburn Rovers,3-0,3,0,1,1,3,3,H,"Ashworth, David",3,Anfield
795,1920-02-26,1919.0,Notts County,Liverpool,1-0,1,0,1,1,1,1,H,"Ashworth, David",0,Away
796,1920-02-28,1919.0,Liverpool,Notts County,3-0,3,0,1,1,3,3,H,"Ashworth, David",3,Anfield
797,1920-03-10,1919.0,Liverpool,Sheffield Wednesday,1-0,1,0,1,1,1,1,H,"Ashworth, David",1,Anfield
798,1920-03-13,1919.0,Sheffield Wednesday,Liverpool,2-2,2,2,1,1,4,0,D,"Ashworth, David",2,Away
799,1920-03-20,1919.0,Liverpool,Manchester City,1-0,1,0,1,1,1,1,H,"Ashworth, David",1,Anfield
800,1920-03-27,1919.0,Manchester City,Liverpool,2-1,2,1,1,1,3,1,H,"Ashworth, David",1,Away
801,1920-04-02,1919.0,Oldham Athletic,Liverpool,1-1,1,1,1,1,2,0,D,"Ashworth, David",1,Away
802,1920-04-03,1919.0,Liverpool,Derby County,3-0,3,0,1,1,3,3,H,"Ashworth, David",3,Anfield
803,1920-04-05,1919.0,Liverpool,Oldham Athletic,2-2,2,2,1,1,4,0,D,"Ashworth, David",2,Anfield
804,1920-04-10,1919.0,Derby County,Liverpool,3-0,3,0,1,1,3,3,H,"Ashworth, David",0,Away
805,1920-04-17,1919.0,Liverpool,West Bromwich Albion,0-0,0,0,1,1,0,0,D,"Ashworth, David",0,Anfield
806,1920-04-24,1919.0,West Bromwich Albion,Liverpool,1-1,1,1,1,1,2,0,D,"Ashworth, David",1,Away
807,1920-05-01,1919.0,Sunderland,Liverpool,0-1,0,1,1,1,1,-1,A,"Ashworth, David",1,Away
808,1920-08-28,1920.0,Liverpool,Manchester City,4-2,4,2,1,1,6,2,H,"Ashworth, David",4,Anfield
809,1920-09-01,1920.0,West Bromwich Albion,Liverpool,1-1,1,1,1,1,2,0,D,"Ashworth, David",1,Away
810,1920-09-04,1920.0,Manchester City,Liverpool,3-2,3,2,1,1,5,1,H,"Ashworth, David",2,Away
811,1920-09-06,1920.0,Liverpool,West Bromwich Albion,0-0,0,0,1,1,0,0,D,"Ashworth, David",0,Anfield
812,1920-09-11,1920.0,Liverpool,Oldham Athletic,5-2,5,2,1,1,7,3,H,"Ashworth, David",5,Anfield
813,1920-09-18,1920.0,Oldham Athletic,Liverpool,0-0,0,0,1,1,0,0,D,"Ashworth, David",0,Away
814,1920-09-25,1920.0,Liverpool,Preston North End,6-0,6,0,1,1,6,6,H,"Ashworth, David",6,Anfield
815,1920-10-02,1920.0,Preston North End,Liverpool,2-3,2,3,1,1,5,-1,A,"Ashworth, David",3,Away
816,1920-10-09,1920.0,Liverpool,Sheffield United,2-2,2,2,1,1,4,0,D,"Ashworth, David",2,Anfield
817,1920-10-16,1920.0,Sheffield United,Liverpool,0-1,0,1,1,1,1,-1,A,"Ashworth, David",1,Away
818,1920-10-23,1920.0,Liverpool,Everton,1-0,1,0,1,1,1,1,H,"Ashworth, David",1,Anfield
819,1920-10-30,1920.0,Everton,Liverpool,0-3,0,3,1,1,3,-3,A,"Ashworth, David",3,Away
820,1920-11-06,1920.0,Liverpool,Bradford Park Avenue,0-1,0,1,1,1,1,-1,A,"Ashworth, David",0,Anfield
821,1920-11-13,1920.0,Bradford Park Avenue,Liverpool,1-3,1,3,1,1,4,-2,A,"Ashworth, David",3,Away
822,1920-11-20,1920.0,Newcastle United,Liverpool,2-0,2,0,1,1,2,2,H,"Ashworth, David",0,Away
823,1920-11-27,1920.0,Liverpool,Newcastle United,0-1,0,1,1,1,1,-1,A,"Ashworth, David",0,Anfield
824,1920-12-04,1920.0,Liverpool,Burnley,0-0,0,0,1,1,0,0,D,"Ashworth, David",0,Anfield
825,1920-12-11,1920.0,Burnley,Liverpool,1-0,1,0,1,1,1,1,H,"Ashworth, David",0,Away
826,1920-12-18,1920.0,Liverpool,Aston Villa,4-1,4,1,1,1,5,3,H,"Ashworth, David",4,Anfield
827,1920-12-25,1920.0,Chelsea,Liverpool,1-1,1,1,1,1,2,0,D,"Ashworth, David",1,Away
828,1920-12-27,1920.0,Liverpool,Chelsea,2-1,2,1,1,1,3,1,H,"Ashworth, David",2,Anfield
829,1921-01-01,1920.0,Aston Villa,Liverpool,0-2,0,2,1,1,2,-2,A,"Ashworth, David",2,Away
830,1921-01-15,1920.0,Liverpool,Sunderland,0-0,0,0,1,1,0,0,D,"Ashworth, David",0,Anfield
831,1921-01-22,1920.0,Sunderland,Liverpool,2-1,2,1,1,1,3,1,H,"Ashworth, David",1,Away
832,1921-02-05,1920.0,Manchester United,Liverpool,1-1,1,1,1,1,2,0,D,"Ashworth, David",1,Away
833,1921-02-09,1920.0,Liverpool,Manchester United,2-0,2,0,1,1,2,2,H,"Ashworth, David",2,Anfield
834,1921-02-12,1920.0,Liverpool,Bradford City,2-1,2,1,1,1,3,1,H,"Ashworth, David",2,Anfield
835,1921-02-19,1920.0,Bradford City,Liverpool,0-0,0,0,1,1,0,0,D,"Ashworth, David",0,Away
836,1921-02-26,1920.0,Liverpool,Huddersfield Town,4-1,4,1,1,1,5,3,H,"Ashworth, David",4,Anfield
837,1921-03-05,1920.0,Huddersfield Town,Liverpool,1-2,1,2,1,1,3,-1,A,"Ashworth, David",2,Away
838,1921-03-12,1920.0,Liverpool,Middlesbrough,0-0,0,0,1,1,0,0,D,"Ashworth, David",0,Anfield
839,1921-03-19,1920.0,Middlesbrough,Liverpool,0-1,0,1,1,1,1,-1,A,"Ashworth, David",1,Away
840,1921-03-25,1920.0,Liverpool,Tottenham Hotspur,1-1,1,1,1,1,2,0,D,"Ashworth, David",1,Anfield
841,1921-03-26,1920.0,Blackburn Rovers,Liverpool,1-1,1,1,1,1,2,0,D,"Ashworth, David",1,Away
842,1921-03-28,1920.0,Tottenham Hotspur,Liverpool,1-0,1,0,1,1,1,1,H,"Ashworth, David",0,Away
843,1921-04-02,1920.0,Liverpool,Blackburn Rovers,2-0,2,0,1,1,2,2,H,"Ashworth, David",2,Anfield
844,1921-04-09,1920.0,Derby County,Liverpool,0-0,0,0,1,1,0,0,D,"Ashworth, David",0,Away
845,1921-04-16,1920.0,Liverpool,Derby County,1-1,1,1,1,1,2,0,D,"Ashworth, David",1,Anfield
846,1921-04-23,1920.0,Bolton Wanderers,Liverpool,1-0,1,0,1,1,1,1,H,"Ashworth, David",0,Away
847,1921-04-30,1920.0,Liverpool,Bolton Wanderers,2-3,2,3,1,1,5,-1,A,"Ashworth, David",2,Anfield
848,1921-05-02,1920.0,Arsenal,Liverpool,0-0,0,0,1,1,0,0,D,"Ashworth, David",0,Away
849,1921-05-07,1920.0,Liverpool,Arsenal,3-0,3,0,1,1,3,3,H,"Ashworth, David",3,Anfield
850,1921-08-27,1921.0,Sunderland,Liverpool,3-0,3,0,1,1,3,3,H,"Ashworth, David",0,Away
851,1921-08-31,1921.0,Liverpool,Manchester City,3-2,3,2,1,1,5,1,H,"Ashworth, David",3,Anfield
852,1921-09-03,1921.0,Liverpool,Sunderland,2-1,2,1,1,1,3,1,H,"Ashworth, David",2,Anfield
853,1921-09-07,1921.0,Manchester City,Liverpool,1-1,1,1,1,1,2,0,D,"Ashworth, David",1,Away
854,1921-09-10,1921.0,Sheffield United,Liverpool,0-1,0,1,1,1,1,-1,A,"Ashworth, David",1,Away
855,1921-09-17,1921.0,Liverpool,Sheffield United,1-1,1,1,1,1,2,0,D,"Ashworth, David",1,Anfield
856,1921-09-24,1921.0,Chelsea,Liverpool,0-1,0,1,1,1,1,-1,A,"Ashworth, David",1,Away
857,1921-10-01,1921.0,Liverpool,Chelsea,1-1,1,1,1,1,2,0,D,"Ashworth, David",1,Anfield
858,1921-10-08,1921.0,Preston North End,Liverpool,1-1,1,1,1,1,2,0,D,"Ashworth, David",1,Away
859,1921-10-15,1921.0,Liverpool,Preston North End,4-0,4,0,1,1,4,4,H,"Ashworth, David",4,Anfield
860,1921-10-22,1921.0,Tottenham Hotspur,Liverpool,0-1,0,1,1,1,1,-1,A,"Ashworth, David",1,Away
861,1921-10-29,1921.0,Liverpool,Tottenham Hotspur,1-1,1,1,1,1,2,0,D,"Ashworth, David",1,Anfield
862,1921-11-05,1921.0,Everton,Liverpool,1-1,1,1,1,1,2,0,D,"Ashworth, David",1,Away
863,1921-11-12,1921.0,Liverpool,Everton,1-1,1,1,1,1,2,0,D,"Ashworth, David",1,Anfield
864,1921-11-19,1921.0,Liverpool,Middlesbrough,4-0,4,0,1,1,4,4,H,"Ashworth, David",4,Anfield
865,1921-11-26,1921.0,Middlesbrough,Liverpool,3-1,3,1,1,1,4,2,H,"Ashworth, David",1,Away
866,1921-12-03,1921.0,Aston Villa,Liverpool,1-1,1,1,1,1,2,0,D,"Ashworth, David",1,Away
867,1921-12-10,1921.0,Liverpool,Aston Villa,2-0,2,0,1,1,2,2,H,"Ashworth, David",2,Anfield
868,1921-12-17,1921.0,Liverpool,Manchester United,2-1,2,1,1,1,3,1,H,"Ashworth, David",2,Anfield
869,1921-12-24,1921.0,Manchester United,Liverpool,0-0,0,0,1,1,0,0,D,"Ashworth, David",0,Away
870,1921-12-26,1921.0,Liverpool,Newcastle United,1-0,1,0,1,1,1,1,H,"Ashworth, David",1,Anfield
871,1921-12-27,1921.0,Liverpool,Huddersfield Town,2-0,2,0,1,1,2,2,H,"Ashworth, David",2,Anfield
872,1921-12-31,1921.0,Bradford City,Liverpool,0-0,0,0,1,1,0,0,D,"Ashworth, David",0,Away
873,1922-01-02,1921.0,Newcastle United,Liverpool,1-1,1,1,1,1,2,0,D,"Ashworth, David",1,Away
874,1922-01-14,1921.0,Liverpool,Bradford City,2-1,2,1,1,1,3,1,H,"Ashworth, David",2,Anfield
875,1922-01-21,1921.0,Huddersfield Town,Liverpool,0-1,0,1,1,1,1,-1,A,"Ashworth, David",1,Away
876,1922-02-04,1921.0,Birmingham City,Liverpool,0-2,0,2,1,1,2,-2,A,"Ashworth, David",2,Away
877,1922-02-11,1921.0,Liverpool,Birmingham City,1-0,1,0,1,1,1,1,H,"Ashworth, David",1,Anfield
878,1922-02-25,1921.0,Liverpool,Arsenal,4-0,4,0,1,1,4,4,H,"Ashworth, David",4,Anfield
879,1922-03-04,1921.0,Blackburn Rovers,Liverpool,0-0,0,0,1,1,0,0,D,"Ashworth, David",0,Away
880,1922-03-11,1921.0,Liverpool,Blackburn Rovers,2-0,2,0,1,1,2,2,H,"Ashworth, David",2,Anfield
881,1922-03-18,1921.0,Liverpool,Bolton Wanderers,0-2,0,2,1,1,2,-2,A,"Ashworth, David",0,Anfield
882,1922-03-22,1921.0,Arsenal,Liverpool,1-0,1,0,1,1,1,1,H,"Ashworth, David",0,Away
883,1922-03-25,1921.0,Bolton Wanderers,Liverpool,1-3,1,3,1,1,4,-2,A,"Ashworth, David",3,Away
884,1922-04-01,1921.0,Liverpool,Oldham Athletic,2-0,2,0,1,1,2,2,H,"Ashworth, David",2,Anfield
885,1922-04-08,1921.0,Oldham Athletic,Liverpool,4-0,4,0,1,1,4,4,H,"Ashworth, David",0,Away
886,1922-04-14,1921.0,Burnley,Liverpool,1-1,1,1,1,1,2,0,D,"Ashworth, David",1,Away
887,1922-04-15,1921.0,Liverpool,Cardiff City,5-1,5,1,1,1,6,4,H,"Ashworth, David",5,Anfield
888,1922-04-17,1921.0,Liverpool,Burnley,2-1,2,1,1,1,3,1,H,"Ashworth, David",2,Anfield
889,1922-04-22,1921.0,Cardiff City,Liverpool,2-0,2,0,1,1,2,2,H,"Ashworth, David",0,Away
890,1922-04-29,1921.0,Liverpool,West Bromwich Albion,1-2,1,2,1,1,3,-1,A,"Ashworth, David",1,Anfield
891,1922-05-06,1921.0,West Bromwich Albion,Liverpool,1-4,1,4,1,1,5,-3,A,"Ashworth, David",4,Away
892,1922-08-26,1922.0,Liverpool,Arsenal,5-2,5,2,1,1,7,3,H,"Ashworth, David",5,Anfield
893,1922-08-30,1922.0,Sunderland,Liverpool,1-0,1,0,1,1,1,1,H,"Ashworth, David",0,Away
894,1922-09-02,1922.0,Arsenal,Liverpool,1-0,1,0,1,1,1,1,H,"Ashworth, David",0,Away
895,1922-09-06,1922.0,Liverpool,Sunderland,5-1,5,1,1,1,6,4,H,"Ashworth, David",5,Anfield
896,1922-09-09,1922.0,Preston North End,Liverpool,1-3,1,3,1,1,4,-2,A,"Ashworth, David",3,Away
897,1922-09-16,1922.0,Liverpool,Preston North End,5-2,5,2,1,1,7,3,H,"Ashworth, David",5,Anfield
898,1922-09-23,1922.0,Liverpool,Burnley,3-0,3,0,1,1,3,3,H,"Ashworth, David",3,Anfield
899,1922-09-30,1922.0,Burnley,Liverpool,2-0,2,0,1,1,2,2,H,"Ashworth, David",0,Away
900,1922-10-07,1922.0,Liverpool,Everton,5-1,5,1,1,1,6,4,H,"Ashworth, David",5,Anfield
901,1922-10-14,1922.0,Everton,Liverpool,0-1,0,1,1,1,1,-1,A,"Ashworth, David",1,Away
902,1922-10-21,1922.0,Liverpool,Cardiff City,3-1,3,1,1,1,4,2,H,"Ashworth, David",3,Anfield
903,1922-10-28,1922.0,Cardiff City,Liverpool,3-0,3,0,1,1,3,3,H,"Ashworth, David",0,Away
904,1922-11-04,1922.0,Tottenham Hotspur,Liverpool,2-4,2,4,1,1,6,-2,A,"Ashworth, David",4,Away
905,1922-11-11,1922.0,Liverpool,Tottenham Hotspur,0-0,0,0,1,1,0,0,D,"Ashworth, David",0,Anfield
906,1922-11-18,1922.0,Liverpool,Aston Villa,3-0,3,0,1,1,3,3,H,"Ashworth, David",3,Anfield
907,1922-11-25,1922.0,Aston Villa,Liverpool,0-1,0,1,1,1,1,-1,A,"Ashworth, David",1,Away
908,1922-12-02,1922.0,Liverpool,Newcastle United,0-2,0,2,1,1,2,-2,A,"Ashworth, David",0,Anfield
909,1922-12-09,1922.0,Newcastle United,Liverpool,0-1,0,1,1,1,1,-1,A,"Ashworth, David",1,Away
910,1922-12-16,1922.0,Liverpool,Nottingham Forest,2-1,2,1,1,1,3,1,H,"Ashworth, David",2,Anfield
911,1922-12-23,1922.0,Nottingham Forest,Liverpool,1-3,1,3,1,1,4,-2,A,"Ashworth, David",3,Away
912,1922-12-25,1922.0,Oldham Athletic,Liverpool,0-2,0,2,1,1,2,-2,A,"Ashworth, David",2,Away
913,1922-12-26,1922.0,Liverpool,Oldham Athletic,2-1,2,1,1,1,3,1,H,"Ashworth, David",2,Anfield
914,1922-12-30,1922.0,Chelsea,Liverpool,0-0,0,0,1,1,0,0,D,"Ashworth, David",0,Away
915,1923-01-06,1922.0,Liverpool,Chelsea,1-0,1,0,1,1,1,1,H,"Ashworth, David",1,Anfield
916,1923-01-20,1922.0,Middlesbrough,Liverpool,0-2,0,2,1,1,2,-2,A,"Ashworth, David",2,Away
917,1923-01-27,1922.0,Liverpool,Middlesbrough,2-0,2,0,1,1,2,2,H,"Ashworth, David",2,Anfield
918,1923-02-07,1922.0,Liverpool,West Bromwich Albion,2-0,2,0,1,1,2,2,H,"Ashworth, David",2,Anfield
919,1923-02-10,1922.0,West Bromwich Albion,Liverpool,0-0,0,0,1,1,0,0,D,"Ashworth, David",0,Away
920,1923-02-17,1922.0,Liverpool,Blackburn Rovers,3-0,3,0,1,1,3,3,H,"McQueen, Matt",3,Anfield
921,1923-03-03,1922.0,Liverpool,Bolton Wanderers,3-0,3,0,1,1,3,3,H,"McQueen, Matt",3,Anfield
922,1923-03-12,1922.0,Blackburn Rovers,Liverpool,1-0,1,0,1,1,1,1,H,"McQueen, Matt",0,Away
923,1923-03-17,1922.0,Manchester City,Liverpool,1-0,1,0,1,1,1,1,H,"McQueen, Matt",0,Away
924,1923-03-24,1922.0,Liverpool,Manchester City,2-0,2,0,1,1,2,2,H,"McQueen, Matt",2,Anfield
925,1923-03-30,1922.0,Liverpool,Sheffield United,2-1,2,1,1,1,3,1,H,"McQueen, Matt",2,Anfield
926,1923-03-31,1922.0,Birmingham City,Liverpool,0-1,0,1,1,1,1,-1,A,"McQueen, Matt",1,Away
927,1923-04-02,1922.0,Sheffield United,Liverpool,4-1,4,1,1,1,5,3,H,"McQueen, Matt",1,Away
928,1923-04-07,1922.0,Liverpool,Birmingham City,0-0,0,0,1,1,0,0,D,"McQueen, Matt",0,Anfield
929,1923-04-14,1922.0,Huddersfield Town,Liverpool,0-0,0,0,1,1,0,0,D,"McQueen, Matt",0,Away
930,1923-04-18,1922.0,Bolton Wanderers,Liverpool,1-1,1,1,1,1,2,0,D,"McQueen, Matt",1,Away
931,1923-04-21,1922.0,Liverpool,Huddersfield Town,1-1,1,1,1,1,2,0,D,"McQueen, Matt",1,Anfield
932,1923-04-28,1922.0,Stoke City,Liverpool,0-0,0,0,1,1,0,0,D,"McQueen, Matt",0,Away
933,1923-05-05,1922.0,Liverpool,Stoke City,1-0,1,0,1,1,1,1,H,"McQueen, Matt",1,Anfield
934,1923-08-25,1923.0,West Bromwich Albion,Liverpool,2-0,2,0,1,1,2,2,H,"McQueen, Matt",0,Away
935,1923-08-29,1923.0,Liverpool,Birmingham City,6-2,6,2,1,1,8,4,H,"McQueen, Matt",6,Anfield
936,1923-09-01,1923.0,Liverpool,West Bromwich Albion,0-0,0,0,1,1,0,0,D,"McQueen, Matt",0,Anfield
937,1923-09-05,1923.0,Birmingham City,Liverpool,2-1,2,1,1,1,3,1,H,"McQueen, Matt",1,Away
938,1923-09-08,1923.0,Preston North End,Liverpool,0-1,0,1,1,1,1,-1,A,"McQueen, Matt",1,Away
939,1923-09-15,1923.0,Liverpool,Preston North End,3-1,3,1,1,1,4,2,H,"McQueen, Matt",3,Anfield
940,1923-09-22,1923.0,Burnley,Liverpool,2-0,2,0,1,1,2,2,H,"McQueen, Matt",0,Away
941,1923-09-29,1923.0,Liverpool,Burnley,1-0,1,0,1,1,1,1,H,"McQueen, Matt",1,Anfield
942,1923-10-06,1923.0,Everton,Liverpool,1-0,1,0,1,1,1,1,H,"McQueen, Matt",0,Away
943,1923-10-13,1923.0,Liverpool,Everton,1-2,1,2,1,1,3,-1,A,"McQueen, Matt",1,Anfield
944,1923-10-20,1923.0,Liverpool,Nottingham Forest,4-2,4,2,1,1,6,2,H,"McQueen, Matt",4,Anfield
945,1923-10-27,1923.0,Nottingham Forest,Liverpool,0-1,0,1,1,1,1,-1,A,"McQueen, Matt",1,Away
946,1923-11-03,1923.0,Liverpool,Huddersfield Town,1-1,1,1,1,1,2,0,D,"McQueen, Matt",1,Anfield
947,1923-11-10,1923.0,Huddersfield Town,Liverpool,3-1,3,1,1,1,4,2,H,"McQueen, Matt",1,Away
948,1923-11-17,1923.0,Aston Villa,Liverpool,0-0,0,0,1,1,0,0,D,"McQueen, Matt",0,Away
949,1923-11-24,1923.0,Liverpool,Aston Villa,0-1,0,1,1,1,1,-1,A,"McQueen, Matt",0,Anfield
950,1923-12-01,1923.0,Sheffield United,Liverpool,1-1,1,1,1,1,2,0,D,"McQueen, Matt",1,Away
951,1923-12-08,1923.0,Liverpool,Sheffield United,2-3,2,3,1,1,5,-1,A,"McQueen, Matt",2,Anfield
952,1923-12-15,1923.0,Liverpool,Cardiff City,0-2,0,2,1,1,2,-2,A,"McQueen, Matt",0,Anfield
953,1923-12-22,1923.0,Cardiff City,Liverpool,2-0,2,0,1,1,2,2,H,"McQueen, Matt",0,Away
954,1923-12-25,1923.0,Liverpool,Newcastle United,0-1,0,1,1,1,1,-1,A,"McQueen, Matt",0,Anfield
955,1923-12-26,1923.0,Newcastle United,Liverpool,2-1,2,1,1,1,3,1,H,"McQueen, Matt",1,Away
956,1923-12-29,1923.0,Liverpool,West Ham United,2-0,2,0,1,1,2,2,H,"McQueen, Matt",2,Anfield
957,1924-01-01,1923.0,Liverpool,Chelsea,3-1,3,1,1,1,4,2,H,"McQueen, Matt",3,Anfield
958,1924-01-05,1923.0,West Ham United,Liverpool,1-0,1,0,1,1,1,1,H,"McQueen, Matt",0,Away
959,1924-01-19,1923.0,Manchester City,Liverpool,0-1,0,1,1,1,1,-1,A,"McQueen, Matt",1,Away
960,1924-01-26,1923.0,Liverpool,Manchester City,0-0,0,0,1,1,0,0,D,"McQueen, Matt",0,Anfield
961,1924-02-09,1923.0,Liverpool,Bolton Wanderers,3-1,3,1,1,1,4,2,H,"McQueen, Matt",3,Anfield
962,1924-02-16,1923.0,Sunderland,Liverpool,0-0,0,0,1,1,0,0,D,"McQueen, Matt",0,Away
963,1924-03-01,1923.0,Arsenal,Liverpool,3-1,3,1,1,1,4,2,H,"McQueen, Matt",1,Away
964,1924-03-12,1923.0,Bolton Wanderers,Liverpool,4-1,4,1,1,1,5,3,H,"McQueen, Matt",1,Away
965,1924-03-15,1923.0,Liverpool,Blackburn Rovers,0-0,0,0,1,1,0,0,D,"McQueen, Matt",0,Anfield
966,1924-03-19,1923.0,Liverpool,Sunderland,4-2,4,2,1,1,6,2,H,"McQueen, Matt",4,Anfield
967,1924-03-22,1923.0,Blackburn Rovers,Liverpool,0-0,0,0,1,1,0,0,D,"McQueen, Matt",0,Away
968,1924-03-29,1923.0,Liverpool,Tottenham Hotspur,1-0,1,0,1,1,1,1,H,"McQueen, Matt",1,Anfield
969,1924-04-02,1923.0,Liverpool,Arsenal,0-0,0,0,1,1,0,0,D,"McQueen, Matt",0,Anfield
970,1924-04-05,1923.0,Tottenham Hotspur,Liverpool,1-1,1,1,1,1,2,0,D,"McQueen, Matt",1,Away
971,1924-04-12,1923.0,Liverpool,Middlesbrough,3-1,3,1,1,1,4,2,H,"McQueen, Matt",3,Anfield
972,1924-04-18,1923.0,Chelsea,Liverpool,2-1,2,1,1,1,3,1,H,"McQueen, Matt",1,Away
973,1924-04-19,1923.0,Middlesbrough,Liverpool,1-1,1,1,1,1,2,0,D,"McQueen, Matt",1,Away
974,1924-04-26,1923.0,Liverpool,Notts County,1-0,1,0,1,1,1,1,H,"McQueen, Matt",1,Anfield
975,1924-05-03,1923.0,Notts County,Liverpool,1-2,1,2,1,1,3,-1,A,"McQueen, Matt",2,Away
976,1924-08-30,1924.0,Liverpool,Aston Villa,2-4,2,4,1,1,6,-2,A,"McQueen, Matt",2,Anfield
977,1924-09-06,1924.0,Arsenal,Liverpool,2-0,2,0,1,1,2,2,H,"McQueen, Matt",0,Away
978,1924-09-13,1924.0,Liverpool,Manchester City,5-3,5,3,1,1,8,2,H,"McQueen, Matt",5,Anfield
979,1924-09-15,1924.0,Blackburn Rovers,Liverpool,3-1,3,1,1,1,4,2,H,"McQueen, Matt",1,Away
980,1924-09-20,1924.0,Bury,Liverpool,0-0,0,0,1,1,0,0,D,"McQueen, Matt",0,Away
981,1924-09-27,1924.0,Liverpool,Nottingham Forest,3-0,3,0,1,1,3,3,H,"McQueen, Matt",3,Anfield
982,1924-10-04,1924.0,Everton,Liverpool,0-1,0,1,1,1,1,-1,A,"McQueen, Matt",1,Away
983,1924-10-11,1924.0,Newcastle United,Liverpool,0-0,0,0,1,1,0,0,D,"McQueen, Matt",0,Away
984,1924-10-15,1924.0,Liverpool,Blackburn Rovers,0-0,0,0,1,1,0,0,D,"McQueen, Matt",0,Anfield
985,1924-10-18,1924.0,Liverpool,Sheffield United,4-1,4,1,1,1,5,3,H,"McQueen, Matt",4,Anfield
986,1924-10-25,1924.0,Liverpool,Sunderland,3-1,3,1,1,1,4,2,H,"McQueen, Matt",3,Anfield
987,1924-11-08,1924.0,Liverpool,Preston North End,3-1,3,1,1,1,4,2,H,"McQueen, Matt",3,Anfield
988,1924-11-12,1924.0,Liverpool,Huddersfield Town,2-3,2,3,1,1,5,-1,A,"McQueen, Matt",2,Anfield
989,1924-11-15,1924.0,Burnley,Liverpool,2-1,2,1,1,1,3,1,H,"McQueen, Matt",1,Away
990,1924-11-22,1924.0,Liverpool,Leeds United,1-0,1,0,1,1,1,1,H,"McQueen, Matt",1,Anfield
991,1924-11-29,1924.0,Birmingham City,Liverpool,5-2,5,2,1,1,7,3,H,"McQueen, Matt",2,Away
992,1924-12-06,1924.0,Liverpool,West Bromwich Albion,1-1,1,1,1,1,2,0,D,"McQueen, Matt",1,Anfield
993,1924-12-13,1924.0,Tottenham Hotspur,Liverpool,1-1,1,1,1,1,2,0,D,"McQueen, Matt",1,Away
994,1924-12-15,1924.0,Cardiff City,Liverpool,1-3,1,3,1,1,4,-2,A,"McQueen, Matt",3,Away
995,1924-12-20,1924.0,Liverpool,Bolton Wanderers,0-0,0,0,1,1,0,0,D,"McQueen, Matt",0,Anfield
996,1924-12-25,1924.0,Notts County,Liverpool,1-2,1,2,1,1,3,-1,A,"McQueen, Matt",2,Away
997,1924-12-26,1924.0,Liverpool,Notts County,1-0,1,0,1,1,1,1,H,"McQueen, Matt",1,Anfield
998,1925-01-03,1924.0,Liverpool,Arsenal,2-1,2,1,1,1,3,1,H,"McQueen, Matt",2,Anfield
999,1925-01-17,1924.0,Manchester City,Liverpool,5-0,5,0,1,1,5,5,H,"McQueen, Matt",0,Away
1000,1925-01-21,1924.0,Aston Villa,Liverpool,1-4,1,4,1,1,5,-3,A,"McQueen, Matt",4,Away
1001,1925-01-24,1924.0,Liverpool,Bury,4-0,4,0,1,1,4,4,H,"McQueen, Matt",4,Anfield
1002,1925-02-04,1924.0,Nottingham Forest,Liverpool,0-1,0,1,1,1,1,-1,A,"McQueen, Matt",1,Away
1003,1925-02-07,1924.0,Liverpool,Everton,3-1,3,1,1,1,4,2,H,"McQueen, Matt",3,Anfield
1004,1925-02-14,1924.0,Liverpool,Newcastle United,1-1,1,1,1,1,2,0,D,"McQueen, Matt",1,Anfield
1005,1925-02-28,1924.0,Sunderland,Liverpool,3-0,3,0,1,1,3,3,H,"McQueen, Matt",0,Away
1006,1925-03-14,1924.0,Preston North End,Liverpool,4-0,4,0,1,1,4,4,H,"McQueen, Matt",0,Away
1007,1925-03-16,1924.0,Sheffield United,Liverpool,0-1,0,1,1,1,1,-1,A,"McQueen, Matt",1,Away
1008,1925-03-21,1924.0,Liverpool,Burnley,3-0,3,0,1,1,3,3,H,"McQueen, Matt",3,Anfield
1009,1925-03-28,1924.0,Leeds United,Liverpool,4-1,4,1,1,1,5,3,H,"McQueen, Matt",1,Away
1010,1925-04-04,1924.0,Liverpool,Birmingham City,1-1,1,1,1,1,2,0,D,"McQueen, Matt",1,Anfield
1011,1925-04-10,1924.0,Liverpool,West Ham United,2-0,2,0,1,1,2,2,H,"McQueen, Matt",2,Anfield
1012,1925-04-11,1924.0,West Bromwich Albion,Liverpool,0-0,0,0,1,1,0,0,D,"McQueen, Matt",0,Away
1013,1925-04-13,1924.0,West Ham United,Liverpool,0-1,0,1,1,1,1,-1,A,"McQueen, Matt",1,Away
1014,1925-04-18,1924.0,Liverpool,Tottenham Hotspur,1-0,1,0,1,1,1,1,H,"McQueen, Matt",1,Anfield
1015,1925-04-25,1924.0,Bolton Wanderers,Liverpool,2-0,2,0,1,1,2,2,H,"McQueen, Matt",0,Away
1016,1925-04-29,1924.0,Liverpool,Cardiff City,1-2,1,2,1,1,3,-1,A,"McQueen, Matt",1,Anfield
1017,1925-05-02,1924.0,Huddersfield Town,Liverpool,1-1,1,1,1,1,2,0,D,"McQueen, Matt",1,Away
1018,1925-08-29,1925.0,Leicester City,Liverpool,3-1,3,1,1,1,4,2,H,"McQueen, Matt",1,Away
1019,1925-09-02,1925.0,Liverpool,Notts County,2-0,2,0,1,1,2,2,H,"McQueen, Matt",2,Anfield
1020,1925-09-05,1925.0,Liverpool,West Ham United,0-0,0,0,1,1,0,0,D,"McQueen, Matt",0,Anfield
1021,1925-09-12,1925.0,Arsenal,Liverpool,1-1,1,1,1,1,2,0,D,"McQueen, Matt",1,Away
1022,1925-09-19,1925.0,Liverpool,Manchester United,5-0,5,0,1,1,5,5,H,"McQueen, Matt",5,Anfield
1023,1925-09-26,1925.0,Liverpool,Everton,5-1,5,1,1,1,6,4,H,"McQueen, Matt",5,Anfield
1024,1925-10-01,1925.0,Notts County,Liverpool,1-2,1,2,1,1,3,-1,A,"McQueen, Matt",2,Away
1025,1925-10-03,1925.0,Burnley,Liverpool,2-1,2,1,1,1,3,1,H,"McQueen, Matt",1,Away
1026,1925-10-10,1925.0,Liverpool,Leeds United,1-1,1,1,1,1,2,0,D,"McQueen, Matt",1,Anfield
1027,1925-10-17,1925.0,Liverpool,Manchester City,2-1,2,1,1,1,3,1,H,"McQueen, Matt",2,Anfield
1028,1925-10-24,1925.0,Tottenham Hotspur,Liverpool,3-1,3,1,1,1,4,2,H,"McQueen, Matt",1,Away
1029,1925-10-31,1925.0,Liverpool,Sunderland,2-2,2,2,1,1,4,0,D,"McQueen, Matt",2,Anfield
1030,1925-11-14,1925.0,Liverpool,West Bromwich Albion,2-0,2,0,1,1,2,2,H,"McQueen, Matt",2,Anfield
1031,1925-11-21,1925.0,Birmingham City,Liverpool,2-0,2,0,1,1,2,2,H,"McQueen, Matt",0,Away
1032,1925-11-25,1925.0,Huddersfield Town,Liverpool,0-0,0,0,1,1,0,0,D,"McQueen, Matt",0,Away
1033,1925-11-28,1925.0,Liverpool,Bury,0-1,0,1,1,1,1,-1,A,"McQueen, Matt",0,Anfield
1034,1925-12-05,1925.0,Blackburn Rovers,Liverpool,1-1,1,1,1,1,2,0,D,"McQueen, Matt",1,Away
1035,1925-12-12,1925.0,Liverpool,Cardiff City,0-2,0,2,1,1,2,-2,A,"McQueen, Matt",0,Anfield
1036,1925-12-19,1925.0,Sheffield United,Liverpool,3-1,3,1,1,1,4,2,H,"McQueen, Matt",1,Away
1037,1925-12-25,1925.0,Liverpool,Newcastle United,6-3,6,3,1,1,9,3,H,"McQueen, Matt",6,Anfield
1038,1925-12-26,1925.0,Newcastle United,Liverpool,3-0,3,0,1,1,3,3,H,"McQueen, Matt",0,Away
1039,1926-01-01,1925.0,Liverpool,Aston Villa,3-1,3,1,1,1,4,2,H,"McQueen, Matt",3,Anfield
1040,1926-01-02,1925.0,Liverpool,Leicester City,0-3,0,3,1,1,3,-3,A,"McQueen, Matt",0,Anfield
1041,1926-01-16,1925.0,West Ham United,Liverpool,1-2,1,2,1,1,3,-1,A,"McQueen, Matt",2,Away
1042,1926-01-23,1925.0,Liverpool,Arsenal,3-0,3,0,1,1,3,3,H,"McQueen, Matt",3,Anfield
1043,1926-02-06,1925.0,Everton,Liverpool,3-3,3,3,1,1,6,0,D,"McQueen, Matt",3,Away
1044,1926-02-13,1925.0,Liverpool,Burnley,3-2,3,2,1,1,5,1,H,"McQueen, Matt",3,Anfield
1045,1926-02-20,1925.0,Leeds United,Liverpool,1-1,1,1,1,1,2,0,D,"McQueen, Matt",1,Away
1046,1926-02-27,1925.0,Manchester City,Liverpool,1-1,1,1,1,1,2,0,D,"McQueen, Matt",1,Away
1047,1926-03-06,1925.0,Liverpool,Tottenham Hotspur,0-0,0,0,1,1,0,0,D,"McQueen, Matt",0,Anfield
1048,1926-03-10,1925.0,Manchester United,Liverpool,3-3,3,3,1,1,6,0,D,"McQueen, Matt",3,Away
1049,1926-03-13,1925.0,Sunderland,Liverpool,3-2,3,2,1,1,5,1,H,"McQueen, Matt",2,Away
1050,1926-03-20,1925.0,Liverpool,Huddersfield Town,1-2,1,2,1,1,3,-1,A,"McQueen, Matt",1,Anfield
1051,1926-03-27,1925.0,West Bromwich Albion,Liverpool,0-3,0,3,1,1,3,-3,A,"McQueen, Matt",3,Away
1052,1926-04-02,1925.0,Bolton Wanderers,Liverpool,0-1,0,1,1,1,1,-1,A,"McQueen, Matt",1,Away
1053,1926-04-03,1925.0,Liverpool,Birmingham City,2-2,2,2,1,1,4,0,D,"McQueen, Matt",2,Anfield
1054,1926-04-05,1925.0,Liverpool,Bolton Wanderers,2-2,2,2,1,1,4,0,D,"McQueen, Matt",2,Anfield
1055,1926-04-06,1925.0,Aston Villa,Liverpool,3-0,3,0,1,1,3,3,H,"McQueen, Matt",0,Away
1056,1926-04-10,1925.0,Bury,Liverpool,0-1,0,1,1,1,1,-1,A,"McQueen, Matt",1,Away
1057,1926-04-17,1925.0,Liverpool,Blackburn Rovers,2-2,2,2,1,1,4,0,D,"McQueen, Matt",2,Anfield
1058,1926-04-24,1925.0,Cardiff City,Liverpool,2-2,2,2,1,1,4,0,D,"McQueen, Matt",2,Away
1059,1926-05-01,1925.0,Liverpool,Sheffield United,2-2,2,2,1,1,4,0,D,"McQueen, Matt",2,Anfield
1060,1926-08-28,1926.0,Liverpool,Manchester United,4-2,4,2,1,1,6,2,H,"McQueen, Matt",4,Anfield
1061,1926-08-30,1926.0,Aston Villa,Liverpool,1-1,1,1,1,1,2,0,D,"McQueen, Matt",1,Away
1062,1926-09-04,1926.0,Derby County,Liverpool,2-1,2,1,1,1,3,1,H,"McQueen, Matt",1,Away
1063,1926-09-08,1926.0,Liverpool,Aston Villa,2-1,2,1,1,1,3,1,H,"McQueen, Matt",2,Anfield
1064,1926-09-11,1926.0,Liverpool,Sheffield United,5-1,5,1,1,1,6,4,H,"McQueen, Matt",5,Anfield
1065,1926-09-18,1926.0,Arsenal,Liverpool,2-0,2,0,1,1,2,2,H,"McQueen, Matt",0,Away
1066,1926-09-25,1926.0,Everton,Liverpool,1-0,1,0,1,1,1,1,H,"McQueen, Matt",0,Away
1067,1926-10-02,1926.0,Liverpool,Leeds United,2-4,2,4,1,1,6,-2,A,"McQueen, Matt",2,Anfield
1068,1926-10-09,1926.0,Newcastle United,Liverpool,1-0,1,0,1,1,1,1,H,"McQueen, Matt",0,Away
1069,1926-10-16,1926.0,Sheffield Wednesday,Liverpool,3-2,3,2,1,1,5,1,H,"McQueen, Matt",2,Away
1070,1926-10-23,1926.0,Liverpool,Leicester City,1-0,1,0,1,1,1,1,H,"McQueen, Matt",1,Anfield
1071,1926-10-30,1926.0,Blackburn Rovers,Liverpool,2-1,2,1,1,1,3,1,H,"McQueen, Matt",1,Away
1072,1926-11-06,1926.0,Liverpool,Huddersfield Town,2-3,2,3,1,1,5,-1,A,"McQueen, Matt",2,Anfield
1073,1926-11-13,1926.0,Sunderland,Liverpool,2-1,2,1,1,1,3,1,H,"McQueen, Matt",1,Away
1074,1926-11-20,1926.0,Liverpool,West Bromwich Albion,2-1,2,1,1,1,3,1,H,"McQueen, Matt",2,Anfield
1075,1926-11-27,1926.0,Bury,Liverpool,0-2,0,2,1,1,2,-2,A,"McQueen, Matt",2,Away
1076,1926-12-04,1926.0,Liverpool,Birmingham City,2-1,2,1,1,1,3,1,H,"McQueen, Matt",2,Anfield
1077,1926-12-11,1926.0,Tottenham Hotspur,Liverpool,1-2,1,2,1,1,3,-1,A,"McQueen, Matt",2,Away
1078,1926-12-18,1926.0,Liverpool,West Ham United,0-0,0,0,1,1,0,0,D,"McQueen, Matt",0,Anfield
1079,1926-12-25,1926.0,Burnley,Liverpool,4-0,4,0,1,1,4,4,H,"McQueen, Matt",0,Away
1080,1926-12-27,1926.0,Liverpool,Burnley,2-2,2,2,1,1,4,0,D,"McQueen, Matt",2,Anfield
1081,1926-12-28,1926.0,Liverpool,Bolton Wanderers,3-2,3,2,1,1,5,1,H,"McQueen, Matt",3,Anfield
1082,1927-01-01,1926.0,Bolton Wanderers,Liverpool,2-1,2,1,1,1,3,1,H,"McQueen, Matt",1,Away
1083,1927-01-15,1926.0,Manchester United,Liverpool,0-1,0,1,1,1,1,-1,A,"McQueen, Matt",1,Away
1084,1927-01-22,1926.0,Liverpool,Derby County,3-2,3,2,1,1,5,1,H,"McQueen, Matt",3,Anfield
1085,1927-02-05,1926.0,Liverpool,Arsenal,3-0,3,0,1,1,3,3,H,"McQueen, Matt",3,Anfield
1086,1927-02-07,1926.0,Sheffield United,Liverpool,1-4,1,4,1,1,5,-3,A,"McQueen, Matt",4,Away
1087,1927-02-12,1926.0,Liverpool,Everton,1-0,1,0,1,1,1,1,H,"McQueen, Matt",1,Anfield
1088,1927-02-23,1926.0,Leeds United,Liverpool,0-0,0,0,1,1,0,0,D,"McQueen, Matt",0,Away
1089,1927-02-26,1926.0,Liverpool,Newcastle United,1-2,1,2,1,1,3,-1,A,"McQueen, Matt",1,Anfield
1090,1927-03-05,1926.0,Liverpool,Sheffield Wednesday,3-0,3,0,1,1,3,3,H,"McQueen, Matt",3,Anfield
1091,1927-03-12,1926.0,Leicester City,Liverpool,3-2,3,2,1,1,5,1,H,"McQueen, Matt",2,Away
1092,1927-03-19,1926.0,Liverpool,Blackburn Rovers,2-2,2,2,1,1,4,0,D,"McQueen, Matt",2,Anfield
1093,1927-03-26,1926.0,Huddersfield Town,Liverpool,1-0,1,0,1,1,1,1,H,"McQueen, Matt",0,Away
1094,1927-04-02,1926.0,Liverpool,Sunderland,1-2,1,2,1,1,3,-1,A,"McQueen, Matt",1,Anfield
1095,1927-04-09,1926.0,West Bromwich Albion,Liverpool,0-1,0,1,1,1,1,-1,A,"McQueen, Matt",1,Away
1096,1927-04-15,1926.0,Liverpool,Cardiff City,5-0,5,0,1,1,5,5,H,"McQueen, Matt",5,Anfield
1097,1927-04-16,1926.0,Liverpool,Bury,2-2,2,2,1,1,4,0,D,"McQueen, Matt",2,Anfield
1098,1927-04-18,1926.0,Cardiff City,Liverpool,2-0,2,0,1,1,2,2,H,"McQueen, Matt",0,Away
1099,1927-04-23,1926.0,Birmingham City,Liverpool,3-0,3,0,1,1,3,3,H,"McQueen, Matt",0,Away
1100,1927-04-30,1926.0,Liverpool,Tottenham Hotspur,1-0,1,0,1,1,1,1,H,"McQueen, Matt",1,Anfield
1101,1927-05-07,1926.0,West Ham United,Liverpool,3-3,3,3,1,1,6,0,D,"McQueen, Matt",3,Away
1102,1927-08-27,1927.0,Sheffield United,Liverpool,1-1,1,1,1,1,2,0,D,"McQueen, Matt",1,Away
1103,1927-08-31,1927.0,Liverpool,Bury,5-1,5,1,1,1,6,4,H,"McQueen, Matt",5,Anfield
1104,1927-09-03,1927.0,Liverpool,Aston Villa,0-0,0,0,1,1,0,0,D,"McQueen, Matt",0,Anfield
1105,1927-09-10,1927.0,Sunderland,Liverpool,2-1,2,1,1,1,3,1,H,"McQueen, Matt",1,Away
1106,1927-09-17,1927.0,Liverpool,Derby County,5-2,5,2,1,1,7,3,H,"McQueen, Matt",5,Anfield
1107,1927-09-19,1927.0,Bury,Liverpool,5-2,5,2,1,1,7,3,H,"McQueen, Matt",2,Away
1108,1927-09-24,1927.0,West Ham United,Liverpool,3-1,3,1,1,1,4,2,H,"McQueen, Matt",1,Away
1109,1927-10-01,1927.0,Liverpool,Portsmouth,8-2,8,2,1,1,10,6,H,"McQueen, Matt",8,Anfield
1110,1927-10-08,1927.0,Leicester City,Liverpool,1-1,1,1,1,1,2,0,D,"McQueen, Matt",1,Away
1111,1927-10-15,1927.0,Everton,Liverpool,1-1,1,1,1,1,2,0,D,"McQueen, Matt",1,Away
1112,1927-10-22,1927.0,Bolton Wanderers,Liverpool,2-1,2,1,1,1,3,1,H,"McQueen, Matt",1,Away
1113,1927-10-29,1927.0,Liverpool,Blackburn Rovers,4-2,4,2,1,1,6,2,H,"McQueen, Matt",4,Anfield
1114,1927-11-05,1927.0,Cardiff City,Liverpool,1-1,1,1,1,1,2,0,D,"McQueen, Matt",1,Away
1115,1927-11-12,1927.0,Liverpool,Sheffield Wednesday,5-2,5,2,1,1,7,3,H,"McQueen, Matt",5,Anfield
1116,1927-11-19,1927.0,Middlesbrough,Liverpool,1-1,1,1,1,1,2,0,D,"McQueen, Matt",1,Away
1117,1927-11-26,1927.0,Liverpool,Huddersfield Town,4-2,4,2,1,1,6,2,H,"McQueen, Matt",4,Anfield
1118,1927-12-03,1927.0,Newcastle United,Liverpool,1-1,1,1,1,1,2,0,D,"McQueen, Matt",1,Away
1119,1927-12-10,1927.0,Liverpool,Birmingham City,2-3,2,3,1,1,5,-1,A,"McQueen, Matt",2,Anfield
1120,1927-12-17,1927.0,Tottenham Hotspur,Liverpool,3-1,3,1,1,1,4,2,H,"McQueen, Matt",1,Away
1121,1927-12-24,1927.0,Liverpool,Manchester United,2-0,2,0,1,1,2,2,H,"McQueen, Matt",2,Anfield
1122,1927-12-27,1927.0,Liverpool,Arsenal,0-2,0,2,1,1,2,-2,A,"McQueen, Matt",0,Anfield
1123,1927-12-31,1927.0,Liverpool,Sheffield United,2-1,2,1,1,1,3,1,H,"McQueen, Matt",2,Anfield
1124,1928-01-02,1927.0,Liverpool,Burnley,2-2,2,2,1,1,4,0,D,"McQueen, Matt",2,Anfield
1125,1928-01-07,1927.0,Aston Villa,Liverpool,3-4,3,4,1,1,7,-1,A,"McQueen, Matt",4,Away
1126,1928-01-21,1927.0,Liverpool,Sunderland,2-5,2,5,1,1,7,-3,A,"McQueen, Matt",2,Anfield
1127,1928-02-04,1927.0,Liverpool,West Ham United,1-3,1,3,1,1,4,-2,A,"McQueen, Matt",1,Anfield
1128,1928-02-11,1927.0,Portsmouth,Liverpool,1-0,1,0,1,1,1,1,H,"McQueen, Matt",0,Away
1129,1928-02-15,1927.0,Derby County,Liverpool,2-3,2,3,1,1,5,-1,A,"McQueen, Matt",3,Away
1130,1928-02-25,1927.0,Liverpool,Everton,3-3,3,3,1,1,6,0,D,character(0),3,Anfield
1131,1928-03-03,1927.0,Liverpool,Bolton Wanderers,4-2,4,2,1,1,6,2,H,character(0),4,Anfield
1132,1928-03-07,1927.0,Arsenal,Liverpool,6-3,6,3,1,1,9,3,H,"Patterson, George",3,Away
1133,1928-03-10,1927.0,Blackburn Rovers,Liverpool,2-1,2,1,1,1,3,1,H,"Patterson, George",1,Away
1134,1928-03-17,1927.0,Liverpool,Cardiff City,1-2,1,2,1,1,3,-1,A,"Patterson, George",1,Anfield
1135,1928-03-24,1927.0,Sheffield Wednesday,Liverpool,4-0,4,0,1,1,4,4,H,"Patterson, George",0,Away
1136,1928-03-31,1927.0,Liverpool,Middlesbrough,1-1,1,1,1,1,2,0,D,"Patterson, George",1,Anfield
1137,1928-04-06,1927.0,Burnley,Liverpool,2-2,2,2,1,1,4,0,D,"Patterson, George",2,Away
1138,1928-04-07,1927.0,Huddersfield Town,Liverpool,2-4,2,4,1,1,6,-2,A,"Patterson, George",4,Away
1139,1928-04-14,1927.0,Liverpool,Newcastle United,0-0,0,0,1,1,0,0,D,"Patterson, George",0,Anfield
1140,1928-04-21,1927.0,Birmingham City,Liverpool,2-0,2,0,1,1,2,2,H,"Patterson, George",0,Away
1141,1928-04-25,1927.0,Liverpool,Leicester City,1-1,1,1,1,1,2,0,D,"Patterson, George",1,Anfield
1142,1928-04-28,1927.0,Liverpool,Tottenham Hotspur,2-0,2,0,1,1,2,2,H,"Patterson, George",2,Anfield
1143,1928-05-05,1927.0,Manchester United,Liverpool,6-1,6,1,1,1,7,5,H,"Patterson, George",1,Away
1144,1928-08-25,1928.0,Liverpool,Bury,3-0,3,0,1,1,3,3,H,"Patterson, George",3,Anfield
1145,1928-09-01,1928.0,Aston Villa,Liverpool,3-1,3,1,1,1,4,2,H,"Patterson, George",1,Away
1146,1928-09-05,1928.0,Liverpool,Sheffield United,1-2,1,2,1,1,3,-1,A,"Patterson, George",1,Anfield
1147,1928-09-08,1928.0,Liverpool,Leicester City,6-3,6,3,1,1,9,3,H,"Patterson, George",6,Anfield
1148,1928-09-10,1928.0,Sheffield United,Liverpool,1-3,1,3,1,1,4,-2,A,"Patterson, George",3,Away
1149,1928-09-15,1928.0,Manchester United,Liverpool,2-2,2,2,1,1,4,0,D,"Patterson, George",2,Away
1150,1928-09-22,1928.0,Liverpool,Leeds United,1-1,1,1,1,1,2,0,D,"Patterson, George",1,Anfield
1151,1928-09-29,1928.0,Everton,Liverpool,1-0,1,0,1,1,1,1,H,"Patterson, George",0,Away
1152,1928-10-06,1928.0,West Ham United,Liverpool,1-1,1,1,1,1,2,0,D,"Patterson, George",1,Away
1153,1928-10-13,1928.0,Liverpool,Newcastle United,2-1,2,1,1,1,3,1,H,"Patterson, George",2,Anfield
1154,1928-10-20,1928.0,Liverpool,Huddersfield Town,2-3,2,3,1,1,5,-1,A,"Patterson, George",2,Anfield
1155,1928-10-27,1928.0,Arsenal,Liverpool,4-4,4,4,1,1,8,0,D,"Patterson, George",4,Away
1156,1928-11-03,1928.0,Liverpool,Birmingham City,1-2,1,2,1,1,3,-1,A,"Patterson, George",1,Anfield
1157,1928-11-10,1928.0,Portsmouth,Liverpool,0-1,0,1,1,1,1,-1,A,"Patterson, George",1,Away
1158,1928-11-17,1928.0,Liverpool,Bolton Wanderers,3-0,3,0,1,1,3,3,H,"Patterson, George",3,Anfield
1159,1928-11-24,1928.0,Sheffield Wednesday,Liverpool,3-2,3,2,1,1,5,1,H,"Patterson, George",2,Away
1160,1928-12-01,1928.0,Liverpool,Derby County,3-0,3,0,1,1,3,3,H,"Patterson, George",3,Anfield
1161,1928-12-08,1928.0,Sunderland,Liverpool,2-1,2,1,1,1,3,1,H,"Patterson, George",1,Away
1162,1928-12-15,1928.0,Liverpool,Blackburn Rovers,1-1,1,1,1,1,2,0,D,"Patterson, George",1,Anfield
1163,1928-12-22,1928.0,Manchester City,Liverpool,2-3,2,3,1,1,5,-1,A,"Patterson, George",3,Away
1164,1928-12-25,1928.0,Burnley,Liverpool,3-2,3,2,1,1,5,1,H,"Patterson, George",2,Away
1165,1928-12-26,1928.0,Liverpool,Burnley,8-0,8,0,1,1,8,8,H,"Patterson, George",8,Anfield
1166,1928-12-29,1928.0,Bury,Liverpool,2-2,2,2,1,1,4,0,D,"Patterson, George",2,Away
1167,1929-01-05,1928.0,Liverpool,Aston Villa,4-0,4,0,1,1,4,4,H,"Patterson, George",4,Anfield
1168,1929-01-19,1928.0,Leicester City,Liverpool,2-0,2,0,1,1,2,2,H,"Patterson, George",0,Away
1169,1929-02-02,1928.0,Leeds United,Liverpool,2-2,2,2,1,1,4,0,D,"Patterson, George",2,Away
1170,1929-02-09,1928.0,Liverpool,Everton,1-2,1,2,1,1,3,-1,A,"Patterson, George",1,Anfield
1171,1929-02-13,1928.0,Liverpool,Manchester United,2-3,2,3,1,1,5,-1,A,"Patterson, George",2,Anfield
1172,1929-02-23,1928.0,Newcastle United,Liverpool,2-2,2,2,1,1,4,0,D,"Patterson, George",2,Away
1173,1929-03-09,1928.0,Liverpool,Arsenal,2-4,2,4,1,1,6,-2,A,"Patterson, George",2,Anfield
1174,1929-03-13,1928.0,Liverpool,West Ham United,2-1,2,1,1,1,3,1,H,"Patterson, George",2,Anfield
1175,1929-03-16,1928.0,Birmingham City,Liverpool,0-0,0,0,1,1,0,0,D,"Patterson, George",0,Away
1176,1929-03-29,1928.0,Liverpool,Cardiff City,2-0,2,0,1,1,2,2,H,"Patterson, George",2,Anfield
1177,1929-03-30,1928.0,Bolton Wanderers,Liverpool,0-0,0,0,1,1,0,0,D,"Patterson, George",0,Away
1178,1929-04-01,1928.0,Cardiff City,Liverpool,1-2,1,2,1,1,3,-1,A,"Patterson, George",2,Away
1179,1929-04-06,1928.0,Liverpool,Sheffield Wednesday,3-2,3,2,1,1,5,1,H,"Patterson, George",3,Anfield
1180,1929-04-10,1928.0,Huddersfield Town,Liverpool,1-3,1,3,1,1,4,-2,A,"Patterson, George",3,Away
1181,1929-04-13,1928.0,Derby County,Liverpool,2-5,2,5,1,1,7,-3,A,"Patterson, George",5,Away
1182,1929-04-17,1928.0,Liverpool,Portsmouth,0-0,0,0,1,1,0,0,D,"Patterson, George",0,Anfield
1183,1929-04-20,1928.0,Liverpool,Sunderland,5-2,5,2,1,1,7,3,H,"Patterson, George",5,Anfield
1184,1929-04-27,1928.0,Blackburn Rovers,Liverpool,2-1,2,1,1,1,3,1,H,"Patterson, George",1,Away
1185,1929-05-04,1928.0,Liverpool,Manchester City,1-1,1,1,1,1,2,0,D,"Patterson, George",1,Anfield
1186,1929-08-31,1929.0,Middlesbrough,Liverpool,5-0,5,0,1,1,5,5,H,"Patterson, George",0,Away
1187,1929-09-04,1929.0,Liverpool,Huddersfield Town,3-0,3,0,1,1,3,3,H,"Patterson, George",3,Anfield
1188,1929-09-07,1929.0,Liverpool,Everton,0-3,0,3,1,1,3,-3,A,"Patterson, George",0,Anfield
1189,1929-09-14,1929.0,Liverpool,West Ham United,3-1,3,1,1,1,4,2,H,"Patterson, George",3,Anfield
1190,1929-09-16,1929.0,Huddersfield Town,Liverpool,3-0,3,0,1,1,3,3,H,"Patterson, George",0,Away
1191,1929-09-21,1929.0,Manchester United,Liverpool,1-2,1,2,1,1,3,-1,A,"Patterson, George",2,Away
1192,1929-09-28,1929.0,Liverpool,Grimsby Town,2-0,2,0,1,1,2,2,H,"Patterson, George",2,Anfield
1193,1929-10-05,1929.0,Leicester City,Liverpool,2-1,2,1,1,1,3,1,H,"Patterson, George",1,Away
1194,1929-10-09,1929.0,Liverpool,Blackburn Rovers,1-1,1,1,1,1,2,0,D,"Patterson, George",1,Anfield
1195,1929-10-12,1929.0,Liverpool,Birmingham City,1-1,1,1,1,1,2,0,D,"Patterson, George",1,Anfield
1196,1929-10-19,1929.0,Derby County,Liverpool,2-2,2,2,1,1,4,0,D,"Patterson, George",2,Away
1197,1929-10-26,1929.0,Liverpool,Manchester City,1-6,1,6,1,1,7,-5,A,"Patterson, George",1,Anfield
1198,1929-11-02,1929.0,Portsmouth,Liverpool,3-3,3,3,1,1,6,0,D,"Patterson, George",3,Away
1199,1929-11-09,1929.0,Liverpool,Bolton Wanderers,3-0,3,0,1,1,3,3,H,"Patterson, George",3,Anfield
1200,1929-11-16,1929.0,Aston Villa,Liverpool,2-3,2,3,1,1,5,-1,A,"Patterson, George",3,Away
1201,1929-11-23,1929.0,Liverpool,Leeds United,1-0,1,0,1,1,1,1,H,"Patterson, George",1,Anfield
1202,1929-11-30,1929.0,Sheffield Wednesday,Liverpool,2-1,2,1,1,1,3,1,H,"Patterson, George",1,Away
1203,1929-12-07,1929.0,Liverpool,Burnley,1-3,1,3,1,1,4,-2,A,"Patterson, George",1,Anfield
1204,1929-12-14,1929.0,Sunderland,Liverpool,2-3,2,3,1,1,5,-1,A,"Patterson, George",3,Away
1205,1929-12-21,1929.0,Liverpool,Arsenal,1-0,1,0,1,1,1,1,H,"Patterson, George",1,Anfield
1206,1929-12-25,1929.0,Sheffield United,Liverpool,4-0,4,0,1,1,4,4,H,"Patterson, George",0,Away
1207,1929-12-26,1929.0,Liverpool,Sheffield United,2-0,2,0,1,1,2,2,H,"Patterson, George",2,Anfield
1208,1929-12-28,1929.0,Liverpool,Middlesbrough,5-2,5,2,1,1,7,3,H,"Patterson, George",5,Anfield
1209,1930-01-04,1929.0,Everton,Liverpool,3-3,3,3,1,1,6,0,D,"Patterson, George",3,Away
1210,1930-01-18,1929.0,West Ham United,Liverpool,4-1,4,1,1,1,5,3,H,"Patterson, George",1,Away
1211,1930-01-25,1929.0,Liverpool,Manchester United,1-0,1,0,1,1,1,1,H,"Patterson, George",1,Anfield
1212,1930-02-01,1929.0,Grimsby Town,Liverpool,3-2,3,2,1,1,5,1,H,"Patterson, George",2,Away
1213,1930-02-08,1929.0,Liverpool,Leicester City,1-1,1,1,1,1,2,0,D,"Patterson, George",1,Anfield
1214,1930-02-15,1929.0,Birmingham City,Liverpool,1-0,1,0,1,1,1,1,H,"Patterson, George",0,Away
1215,1930-02-22,1929.0,Liverpool,Derby County,2-2,2,2,1,1,4,0,D,"Patterson, George",2,Anfield
1216,1930-03-01,1929.0,Manchester City,Liverpool,4-3,4,3,1,1,7,1,H,"Patterson, George",3,Away
1217,1930-03-08,1929.0,Liverpool,Portsmouth,2-0,2,0,1,1,2,2,H,"Patterson, George",2,Anfield
1218,1930-03-15,1929.0,Bolton Wanderers,Liverpool,0-2,0,2,1,1,2,-2,A,"Patterson, George",2,Away
1219,1930-03-22,1929.0,Liverpool,Aston Villa,2-0,2,0,1,1,2,2,H,"Patterson, George",2,Anfield
1220,1930-03-29,1929.0,Leeds United,Liverpool,1-1,1,1,1,1,2,0,D,"Patterson, George",1,Away
1221,1930-04-02,1929.0,Arsenal,Liverpool,0-1,0,1,1,1,1,-1,A,"Patterson, George",1,Away
1222,1930-04-05,1929.0,Liverpool,Sheffield Wednesday,1-3,1,3,1,1,4,-2,A,"Patterson, George",1,Anfield
1223,1930-04-12,1929.0,Burnley,Liverpool,4-1,4,1,1,1,5,3,H,"Patterson, George",1,Away
1224,1930-04-18,1929.0,Newcastle United,Liverpool,3-1,3,1,1,1,4,2,H,"Patterson, George",1,Away
1225,1930-04-19,1929.0,Liverpool,Sunderland,0-6,0,6,1,1,6,-6,A,"Patterson, George",0,Anfield
1226,1930-04-21,1929.0,Liverpool,Newcastle United,0-0,0,0,1,1,0,0,D,"Patterson, George",0,Anfield
1227,1930-05-03,1929.0,Blackburn Rovers,Liverpool,1-0,1,0,1,1,1,1,H,"Patterson, George",0,Away
1228,1930-08-30,1930.0,Liverpool,Blackburn Rovers,2-1,2,1,1,1,3,1,H,"Patterson, George",2,Anfield
1229,1930-09-01,1930.0,West Ham United,Liverpool,7-0,7,0,1,1,7,7,H,"Patterson, George",0,Away
1230,1930-09-06,1930.0,Middlesbrough,Liverpool,3-3,3,3,1,1,6,0,D,"Patterson, George",3,Away
1231,1930-09-10,1930.0,Liverpool,Bolton Wanderers,7-2,7,2,1,1,9,5,H,"Patterson, George",7,Anfield
1232,1930-09-13,1930.0,Liverpool,Huddersfield Town,1-4,1,4,1,1,5,-3,A,"Patterson, George",1,Anfield
1233,1930-09-20,1930.0,Aston Villa,Liverpool,4-2,4,2,1,1,6,2,H,"Patterson, George",2,Away
1234,1930-09-27,1930.0,Liverpool,Chelsea,3-1,3,1,1,1,4,2,H,"Patterson, George",3,Anfield
1235,1930-10-04,1930.0,Newcastle United,Liverpool,0-4,0,4,1,1,4,-4,A,"Patterson, George",4,Away
1236,1930-10-11,1930.0,Liverpool,Sheffield Wednesday,1-2,1,2,1,1,3,-1,A,"Patterson, George",1,Anfield
1237,1930-10-18,1930.0,Liverpool,Leeds United,2-0,2,0,1,1,2,2,H,"Patterson, George",2,Anfield
1238,1930-10-25,1930.0,Blackpool,Liverpool,1-3,1,3,1,1,4,-2,A,"Patterson, George",3,Away
1239,1930-11-01,1930.0,Liverpool,Manchester City,0-2,0,2,1,1,2,-2,A,"Patterson, George",0,Anfield
1240,1930-11-08,1930.0,Derby County,Liverpool,2-2,2,2,1,1,4,0,D,"Patterson, George",2,Away
1241,1930-11-15,1930.0,Liverpool,Leicester City,3-1,3,1,1,1,4,2,H,"Patterson, George",3,Anfield
1242,1930-11-22,1930.0,Portsmouth,Liverpool,4-0,4,0,1,1,4,4,H,"Patterson, George",0,Away
1243,1930-11-29,1930.0,Liverpool,Sheffield United,6-1,6,1,1,1,7,5,H,"Patterson, George",6,Anfield
1244,1930-12-06,1930.0,Sunderland,Liverpool,6-5,6,5,1,1,11,1,H,"Patterson, George",5,Away
1245,1930-12-13,1930.0,Liverpool,Arsenal,1-1,1,1,1,1,2,0,D,"Patterson, George",1,Anfield
1246,1930-12-20,1930.0,Birmingham City,Liverpool,2-0,2,0,1,1,2,2,H,"Patterson, George",0,Away
1247,1930-12-25,1930.0,Grimsby Town,Liverpool,0-0,0,0,1,1,0,0,D,"Patterson, George",0,Away
1248,1930-12-26,1930.0,Liverpool,Grimsby Town,1-1,1,1,1,1,2,0,D,"Patterson, George",1,Anfield
1249,1930-12-27,1930.0,Blackburn Rovers,Liverpool,3-3,3,3,1,1,6,0,D,"Patterson, George",3,Away
1250,1931-01-03,1930.0,Liverpool,Middlesbrough,3-1,3,1,1,1,4,2,H,"Patterson, George",3,Anfield
1251,1931-01-14,1930.0,Bolton Wanderers,Liverpool,2-0,2,0,1,1,2,2,H,"Patterson, George",0,Away
1252,1931-01-17,1930.0,Huddersfield Town,Liverpool,2-1,2,1,1,1,3,1,H,"Patterson, George",1,Away
1253,1931-01-24,1930.0,Liverpool,Aston Villa,1-1,1,1,1,1,2,0,D,"Patterson, George",1,Anfield
1254,1931-01-31,1930.0,Chelsea,Liverpool,2-2,2,2,1,1,4,0,D,"Patterson, George",2,Away
1255,1931-02-07,1930.0,Liverpool,Newcastle United,4-2,4,2,1,1,6,2,H,"Patterson, George",4,Anfield
1256,1931-02-14,1930.0,Sheffield Wednesday,Liverpool,3-5,3,5,1,1,8,-2,A,"Patterson, George",5,Away
1257,1931-02-21,1930.0,Leeds United,Liverpool,1-2,1,2,1,1,3,-1,A,"Patterson, George",2,Away
1258,1931-02-28,1930.0,Liverpool,Blackpool,5-2,5,2,1,1,7,3,H,"Patterson, George",5,Anfield
1259,1931-03-07,1930.0,Manchester City,Liverpool,1-1,1,1,1,1,2,0,D,"Patterson, George",1,Away
1260,1931-03-14,1930.0,Liverpool,Derby County,0-0,0,0,1,1,0,0,D,"Patterson, George",0,Anfield
1261,1931-03-21,1930.0,Leicester City,Liverpool,3-2,3,2,1,1,5,1,H,"Patterson, George",2,Away
1262,1931-03-28,1930.0,Liverpool,Portsmouth,3-1,3,1,1,1,4,2,H,"Patterson, George",3,Anfield
1263,1931-04-03,1930.0,Liverpool,Manchester United,1-1,1,1,1,1,2,0,D,"Patterson, George",1,Anfield
1264,1931-04-04,1930.0,Sheffield United,Liverpool,4-1,4,1,1,1,5,3,H,"Patterson, George",1,Away
1265,1931-04-06,1930.0,Manchester United,Liverpool,4-1,4,1,1,1,5,3,H,"Patterson, George",1,Away
1266,1931-04-11,1930.0,Liverpool,Sunderland,2-4,2,4,1,1,6,-2,A,"Patterson, George",2,Anfield
1267,1931-04-15,1930.0,Liverpool,Birmingham City,0-0,0,0,1,1,0,0,D,"Patterson, George",0,Anfield
1268,1931-04-18,1930.0,Arsenal,Liverpool,3-1,3,1,1,1,4,2,H,"Patterson, George",1,Away
1269,1931-05-02,1930.0,Liverpool,West Ham United,2-0,2,0,1,1,2,2,H,"Patterson, George",2,Anfield
1270,1931-08-29,1931.0,Newcastle United,Liverpool,0-1,0,1,1,1,1,-1,A,"Patterson, George",1,Away
1271,1931-09-02,1931.0,Liverpool,Bolton Wanderers,2-2,2,2,1,1,4,0,D,"Patterson, George",2,Anfield
1272,1931-09-05,1931.0,Liverpool,Aston Villa,2-0,2,0,1,1,2,2,H,"Patterson, George",2,Anfield
1273,1931-09-09,1931.0,Middlesbrough,Liverpool,4-1,4,1,1,1,5,3,H,"Patterson, George",1,Away
1274,1931-09-12,1931.0,Leicester City,Liverpool,2-1,2,1,1,1,3,1,H,"Patterson, George",1,Away
1275,1931-09-16,1931.0,Liverpool,Middlesbrough,7-2,7,2,1,1,9,5,H,"Patterson, George",7,Anfield
1276,1931-09-19,1931.0,Liverpool,Everton,1-3,1,3,1,1,4,-2,A,"Patterson, George",1,Anfield
1277,1931-09-26,1931.0,Liverpool,Grimsby Town,4-0,4,0,1,1,4,4,H,"Patterson, George",4,Anfield
1278,1931-10-03,1931.0,Chelsea,Liverpool,2-0,2,0,1,1,2,2,H,"Patterson, George",0,Away
1279,1931-10-10,1931.0,Liverpool,West Ham United,2-2,2,2,1,1,4,0,D,"Patterson, George",2,Anfield
1280,1931-10-17,1931.0,West Bromwich Albion,Liverpool,1-2,1,2,1,1,3,-1,A,"Patterson, George",2,Away
1281,1931-10-24,1931.0,Liverpool,Blackpool,3-2,3,2,1,1,5,1,H,"Patterson, George",3,Anfield
1282,1931-10-31,1931.0,Sheffield United,Liverpool,3-0,3,0,1,1,3,3,H,"Patterson, George",0,Away
1283,1931-11-07,1931.0,Liverpool,Blackburn Rovers,4-2,4,2,1,1,6,2,H,"Patterson, George",4,Anfield
1284,1931-11-14,1931.0,Sunderland,Liverpool,1-3,1,3,1,1,4,-2,A,"Patterson, George",3,Away
1285,1931-11-21,1931.0,Liverpool,Manchester City,4-3,4,3,1,1,7,1,H,"Patterson, George",4,Anfield
1286,1931-11-28,1931.0,Arsenal,Liverpool,6-0,6,0,1,1,6,6,H,"Patterson, George",0,Away
1287,1931-12-05,1931.0,Liverpool,Birmingham City,4-3,4,3,1,1,7,1,H,"Patterson, George",4,Anfield
1288,1931-12-12,1931.0,Portsmouth,Liverpool,2-0,2,0,1,1,2,2,H,"Patterson, George",0,Away
1289,1931-12-19,1931.0,Liverpool,Derby County,1-1,1,1,1,1,2,0,D,"Patterson, George",1,Anfield
1290,1931-12-25,1931.0,Liverpool,Sheffield Wednesday,3-1,3,1,1,1,4,2,H,"Patterson, George",3,Anfield
1291,1931-12-26,1931.0,Sheffield Wednesday,Liverpool,1-1,1,1,1,1,2,0,D,"Patterson, George",1,Away
1292,1932-01-02,1931.0,Liverpool,Newcastle United,4-2,4,2,1,1,6,2,H,"Patterson, George",4,Anfield
1293,1932-01-16,1931.0,Aston Villa,Liverpool,6-1,6,1,1,1,7,5,H,"Patterson, George",1,Away
1294,1932-01-27,1931.0,Liverpool,Leicester City,3-3,3,3,1,1,6,0,D,"Patterson, George",3,Anfield
1295,1932-01-30,1931.0,Everton,Liverpool,2-1,2,1,1,1,3,1,H,"Patterson, George",1,Away
1296,1932-02-06,1931.0,Grimsby Town,Liverpool,5-1,5,1,1,1,6,4,H,"Patterson, George",1,Away
1297,1932-02-20,1931.0,West Ham United,Liverpool,1-0,1,0,1,1,1,1,H,"Patterson, George",0,Away
1298,1932-03-02,1931.0,Liverpool,West Bromwich Albion,4-1,4,1,1,1,5,3,H,"Patterson, George",4,Anfield
1299,1932-03-05,1931.0,Blackpool,Liverpool,2-2,2,2,1,1,4,0,D,"Patterson, George",2,Away
1300,1932-03-12,1931.0,Liverpool,Sheffield United,2-1,2,1,1,1,3,1,H,"Patterson, George",2,Anfield
1301,1932-03-19,1931.0,Blackburn Rovers,Liverpool,1-3,1,3,1,1,4,-2,A,"Patterson, George",3,Away
1302,1932-03-26,1931.0,Liverpool,Sunderland,1-2,1,2,1,1,3,-1,A,"Patterson, George",1,Anfield
1303,1932-03-28,1931.0,Liverpool,Huddersfield Town,0-3,0,3,1,1,3,-3,A,"Patterson, George",0,Anfield
1304,1932-03-29,1931.0,Huddersfield Town,Liverpool,4-3,4,3,1,1,7,1,H,"Patterson, George",3,Away
1305,1932-04-02,1931.0,Manchester City,Liverpool,0-1,0,1,1,1,1,-1,A,"Patterson, George",1,Away
1306,1932-04-06,1931.0,Liverpool,Chelsea,2-1,2,1,1,1,3,1,H,"Patterson, George",2,Anfield
1307,1932-04-09,1931.0,Liverpool,Arsenal,2-1,2,1,1,1,3,1,H,"Patterson, George",2,Anfield
1308,1932-04-16,1931.0,Birmingham City,Liverpool,3-1,3,1,1,1,4,2,H,"Patterson, George",1,Away
1309,1932-04-23,1931.0,Liverpool,Portsmouth,1-3,1,3,1,1,4,-2,A,"Patterson, George",1,Anfield
1310,1932-04-30,1931.0,Derby County,Liverpool,1-2,1,2,1,1,3,-1,A,"Patterson, George",2,Away
1311,1932-05-07,1931.0,Bolton Wanderers,Liverpool,8-1,8,1,1,1,9,7,H,"Patterson, George",1,Away
1312,1932-08-27,1932.0,Liverpool,Wolverhampton Wanderers,5-1,5,1,1,1,6,4,H,"Patterson, George",5,Anfield
1313,1932-08-29,1932.0,Sheffield United,Liverpool,6-2,6,2,1,1,8,4,H,"Patterson, George",2,Away
1314,1932-09-03,1932.0,Newcastle United,Liverpool,4-3,4,3,1,1,7,1,H,"Patterson, George",3,Away
1315,1932-09-07,1932.0,Liverpool,Sheffield United,2-2,2,2,1,1,4,0,D,"Patterson, George",2,Anfield
1316,1932-09-10,1932.0,Liverpool,Aston Villa,0-0,0,0,1,1,0,0,D,"Patterson, George",0,Anfield
1317,1932-09-17,1932.0,Middlesbrough,Liverpool,0-1,0,1,1,1,1,-1,A,"Patterson, George",1,Away
1318,1932-09-24,1932.0,Liverpool,Bolton Wanderers,0-1,0,1,1,1,1,-1,A,"Patterson, George",0,Anfield
1319,1932-10-01,1932.0,Everton,Liverpool,3-1,3,1,1,1,4,2,H,"Patterson, George",1,Away
1320,1932-10-08,1932.0,Leicester City,Liverpool,1-2,1,2,1,1,3,-1,A,"Patterson, George",2,Away
1321,1932-10-15,1932.0,Liverpool,Portsmouth,4-3,4,3,1,1,7,1,H,"Patterson, George",4,Anfield
1322,1932-10-22,1932.0,Liverpool,Arsenal,2-3,2,3,1,1,5,-1,A,"Patterson, George",2,Anfield
1323,1932-10-29,1932.0,Manchester City,Liverpool,1-1,1,1,1,1,2,0,D,"Patterson, George",1,Away
1324,1932-11-05,1932.0,Liverpool,Leeds United,0-1,0,1,1,1,1,-1,A,"Patterson, George",0,Anfield
1325,1932-11-12,1932.0,Blackburn Rovers,Liverpool,2-2,2,2,1,1,4,0,D,"Patterson, George",2,Away
1326,1932-11-19,1932.0,Liverpool,Derby County,6-1,6,1,1,1,7,5,H,"Patterson, George",6,Anfield
1327,1932-11-26,1932.0,Blackpool,Liverpool,4-1,4,1,1,1,5,3,H,"Patterson, George",1,Away
1328,1932-12-03,1932.0,Liverpool,Sunderland,3-3,3,3,1,1,6,0,D,"Patterson, George",3,Anfield
1329,1932-12-10,1932.0,Birmingham City,Liverpool,3-0,3,0,1,1,3,3,H,"Patterson, George",0,Away
1330,1932-12-17,1932.0,Liverpool,West Bromwich Albion,2-0,2,0,1,1,2,2,H,"Patterson, George",2,Anfield
1331,1932-12-24,1932.0,Sheffield Wednesday,Liverpool,3-0,3,0,1,1,3,3,H,"Patterson, George",0,Away
1332,1932-12-26,1932.0,Liverpool,Chelsea,3-0,3,0,1,1,3,3,H,"Patterson, George",3,Anfield
1333,1932-12-27,1932.0,Chelsea,Liverpool,0-2,0,2,1,1,2,-2,A,"Patterson, George",2,Away
1334,1932-12-31,1932.0,Wolverhampton Wanderers,Liverpool,3-1,3,1,1,1,4,2,H,"Patterson, George",1,Away
1335,1933-01-07,1932.0,Liverpool,Newcastle United,3-0,3,0,1,1,3,3,H,"Patterson, George",3,Anfield
1336,1933-01-21,1932.0,Aston Villa,Liverpool,5-2,5,2,1,1,7,3,H,"Patterson, George",2,Away
1337,1933-02-01,1932.0,Liverpool,Middlesbrough,1-3,1,3,1,1,4,-2,A,"Patterson, George",1,Anfield
1338,1933-02-04,1932.0,Bolton Wanderers,Liverpool,3-3,3,3,1,1,6,0,D,"Patterson, George",3,Away
1339,1933-02-11,1932.0,Liverpool,Everton,7-4,7,4,1,1,11,3,H,"Patterson, George",7,Anfield
1340,1933-02-18,1932.0,Liverpool,Leicester City,1-2,1,2,1,1,3,-1,A,"Patterson, George",1,Anfield
1341,1933-02-25,1932.0,Portsmouth,Liverpool,2-1,2,1,1,1,3,1,H,"Patterson, George",1,Away
1342,1933-03-04,1932.0,Arsenal,Liverpool,0-1,0,1,1,1,1,-1,A,"Patterson, George",1,Away
1343,1933-03-11,1932.0,Liverpool,Manchester City,1-1,1,1,1,1,2,0,D,"Patterson, George",1,Anfield
1344,1933-03-18,1932.0,Leeds United,Liverpool,5-0,5,0,1,1,5,5,H,"Patterson, George",0,Away
1345,1933-03-25,1932.0,Liverpool,Blackburn Rovers,2-2,2,2,1,1,4,0,D,"Patterson, George",2,Anfield
1346,1933-04-01,1932.0,Derby County,Liverpool,1-1,1,1,1,1,2,0,D,"Patterson, George",1,Away
1347,1933-04-08,1932.0,Liverpool,Blackpool,4-3,4,3,1,1,7,1,H,"Patterson, George",4,Anfield
1348,1933-04-14,1932.0,Liverpool,Huddersfield Town,2-2,2,2,1,1,4,0,D,"Patterson, George",2,Anfield
1349,1933-04-15,1932.0,Sunderland,Liverpool,0-0,0,0,1,1,0,0,D,"Patterson, George",0,Away
1350,1933-04-18,1932.0,Huddersfield Town,Liverpool,3-1,3,1,1,1,4,2,H,"Patterson, George",1,Away
1351,1933-04-22,1932.0,Liverpool,Birmingham City,1-0,1,0,1,1,1,1,H,"Patterson, George",1,Anfield
1352,1933-04-29,1932.0,West Bromwich Albion,Liverpool,2-1,2,1,1,1,3,1,H,"Patterson, George",1,Away
1353,1933-05-06,1932.0,Liverpool,Sheffield Wednesday,4-1,4,1,1,1,5,3,H,"Patterson, George",4,Anfield
1354,1933-08-26,1933.0,Wolverhampton Wanderers,Liverpool,3-2,3,2,1,1,5,1,H,"Patterson, George",2,Away
1355,1933-08-30,1933.0,Liverpool,Stoke City,1-1,1,1,1,1,2,0,D,"Patterson, George",1,Anfield
1356,1933-09-02,1933.0,Liverpool,Sheffield United,3-2,3,2,1,1,5,1,H,"Patterson, George",3,Anfield
1357,1933-09-04,1933.0,Stoke City,Liverpool,1-1,1,1,1,1,2,0,D,"Patterson, George",1,Away
1358,1933-09-09,1933.0,Aston Villa,Liverpool,4-2,4,2,1,1,6,2,H,"Patterson, George",2,Away
1359,1933-09-16,1933.0,Liverpool,Leicester City,1-3,1,3,1,1,4,-2,A,"Patterson, George",1,Anfield
1360,1933-09-23,1933.0,Tottenham Hotspur,Liverpool,0-3,0,3,1,1,3,-3,A,"Patterson, George",3,Away
1361,1933-09-30,1933.0,Liverpool,Everton,3-2,3,2,1,1,5,1,H,"Patterson, George",3,Anfield
1362,1933-10-07,1933.0,Liverpool,Chelsea,3-0,3,0,1,1,3,3,H,"Patterson, George",3,Anfield
1363,1933-10-14,1933.0,Sunderland,Liverpool,4-1,4,1,1,1,5,3,H,"Patterson, George",1,Away
1364,1933-10-21,1933.0,Middlesbrough,Liverpool,4-1,4,1,1,1,5,3,H,"Patterson, George",1,Away
1365,1933-10-28,1933.0,Liverpool,Blackburn Rovers,4-0,4,0,1,1,4,4,H,"Patterson, George",4,Anfield
1366,1933-11-04,1933.0,Birmingham City,Liverpool,1-2,1,2,1,1,3,-1,A,"Patterson, George",2,Away
1367,1933-11-11,1933.0,Liverpool,Leeds United,4-3,4,3,1,1,7,1,H,"Patterson, George",4,Anfield
1368,1933-11-18,1933.0,Derby County,Liverpool,3-1,3,1,1,1,4,2,H,"Patterson, George",1,Away
1369,1933-11-25,1933.0,Liverpool,West Bromwich Albion,1-1,1,1,1,1,2,0,D,"Patterson, George",1,Anfield
1370,1933-12-02,1933.0,Arsenal,Liverpool,2-1,2,1,1,1,3,1,H,"Patterson, George",1,Away
1371,1933-12-09,1933.0,Liverpool,Sheffield Wednesday,1-3,1,3,1,1,4,-2,A,"Patterson, George",1,Anfield
1372,1933-12-16,1933.0,Manchester City,Liverpool,2-1,2,1,1,1,3,1,H,"Patterson, George",1,Away
1373,1933-12-23,1933.0,Liverpool,Newcastle United,1-2,1,2,1,1,3,-1,A,"Patterson, George",1,Anfield
1374,1933-12-25,1933.0,Liverpool,Portsmouth,2-2,2,2,1,1,4,0,D,"Patterson, George",2,Anfield
1375,1933-12-26,1933.0,Portsmouth,Liverpool,1-0,1,0,1,1,1,1,H,"Patterson, George",0,Away
1376,1933-12-30,1933.0,Liverpool,Wolverhampton Wanderers,1-1,1,1,1,1,2,0,D,"Patterson, George",1,Anfield
1377,1934-01-01,1933.0,Newcastle United,Liverpool,9-2,9,2,1,1,11,7,H,"Patterson, George",2,Away
1378,1934-01-06,1933.0,Sheffield United,Liverpool,2-2,2,2,1,1,4,0,D,"Patterson, George",2,Away
1379,1934-01-20,1933.0,Liverpool,Aston Villa,2-3,2,3,1,1,5,-1,A,"Patterson, George",2,Anfield
1380,1934-02-01,1933.0,Leicester City,Liverpool,1-0,1,0,1,1,1,1,H,"Patterson, George",0,Away
1381,1934-02-03,1933.0,Liverpool,Tottenham Hotspur,3-1,3,1,1,1,4,2,H,"Patterson, George",3,Anfield
1382,1934-02-10,1933.0,Everton,Liverpool,0-0,0,0,1,1,0,0,D,"Patterson, George",0,Away
1383,1934-02-21,1933.0,Chelsea,Liverpool,2-0,2,0,1,1,2,2,H,"Patterson, George",0,Away
1384,1934-02-24,1933.0,Liverpool,Sunderland,1-1,1,1,1,1,2,0,D,"Patterson, George",1,Anfield
1385,1934-03-03,1933.0,Liverpool,Middlesbrough,6-2,6,2,1,1,8,4,H,"Patterson, George",6,Anfield
1386,1934-03-10,1933.0,Blackburn Rovers,Liverpool,3-1,3,1,1,1,4,2,H,"Patterson, George",1,Away
1387,1934-03-17,1933.0,Liverpool,Birmingham City,4-1,4,1,1,1,5,3,H,"Patterson, George",4,Anfield
1388,1934-03-24,1933.0,Leeds United,Liverpool,5-1,5,1,1,1,6,4,H,"Patterson, George",1,Away
1389,1934-03-30,1933.0,Liverpool,Huddersfield Town,2-2,2,2,1,1,4,0,D,"Patterson, George",2,Anfield
1390,1934-03-31,1933.0,Liverpool,Derby County,4-2,4,2,1,1,6,2,H,"Patterson, George",4,Anfield
1391,1934-04-03,1933.0,Huddersfield Town,Liverpool,0-2,0,2,1,1,2,-2,A,"Patterson, George",2,Away
1392,1934-04-07,1933.0,West Bromwich Albion,Liverpool,2-2,2,2,1,1,4,0,D,"Patterson, George",2,Away
1393,1934-04-14,1933.0,Liverpool,Arsenal,2-3,2,3,1,1,5,-1,A,"Patterson, George",2,Anfield
1394,1934-04-21,1933.0,Sheffield Wednesday,Liverpool,1-2,1,2,1,1,3,-1,A,"Patterson, George",2,Away
1395,1934-05-02,1933.0,Liverpool,Manchester City,3-2,3,2,1,1,5,1,H,"Patterson, George",3,Anfield
1396,1934-08-25,1934.0,Liverpool,Blackburn Rovers,2-0,2,0,1,1,2,2,H,"Patterson, George",2,Anfield
1397,1934-08-29,1934.0,Manchester City,Liverpool,3-1,3,1,1,1,4,2,H,"Patterson, George",1,Away
1398,1934-09-01,1934.0,Arsenal,Liverpool,8-1,8,1,1,1,9,7,H,"Patterson, George",1,Away
1399,1934-09-05,1934.0,Liverpool,Manchester City,2-1,2,1,1,1,3,1,H,"Patterson, George",2,Anfield
1400,1934-09-08,1934.0,Liverpool,Portsmouth,0-1,0,1,1,1,1,-1,A,"Patterson, George",0,Anfield
1401,1934-09-15,1934.0,Everton,Liverpool,1-0,1,0,1,1,1,1,H,"Patterson, George",0,Away
1402,1934-09-22,1934.0,Leeds United,Liverpool,0-3,0,3,1,1,3,-3,A,"Patterson, George",3,Away
1403,1934-09-29,1934.0,Liverpool,West Bromwich Albion,3-2,3,2,1,1,5,1,H,"Patterson, George",3,Anfield
1404,1934-10-06,1934.0,Sheffield Wednesday,Liverpool,4-1,4,1,1,1,5,3,H,"Patterson, George",1,Away
1405,1934-10-13,1934.0,Liverpool,Birmingham City,5-4,5,4,1,1,9,1,H,"Patterson, George",5,Anfield
1406,1934-10-20,1934.0,Liverpool,Grimsby Town,1-1,1,1,1,1,2,0,D,"Patterson, George",1,Anfield
1407,1934-10-27,1934.0,Preston North End,Liverpool,2-2,2,2,1,1,4,0,D,"Patterson, George",2,Away
1408,1934-11-03,1934.0,Liverpool,Wolverhampton Wanderers,2-1,2,1,1,1,3,1,H,"Patterson, George",2,Anfield
1409,1934-11-10,1934.0,Huddersfield Town,Liverpool,8-0,8,0,1,1,8,8,H,"Patterson, George",0,Away
1410,1934-11-17,1934.0,Liverpool,Leicester City,5-1,5,1,1,1,6,4,H,"Patterson, George",5,Anfield
1411,1934-11-24,1934.0,Derby County,Liverpool,1-2,1,2,1,1,3,-1,A,"Patterson, George",2,Away
1412,1934-12-01,1934.0,Liverpool,Aston Villa,3-1,3,1,1,1,4,2,H,"Patterson, George",3,Anfield
1413,1934-12-08,1934.0,Chelsea,Liverpool,4-1,4,1,1,1,5,3,H,"Patterson, George",1,Away
1414,1934-12-15,1934.0,Liverpool,Tottenham Hotspur,4-1,4,1,1,1,5,3,H,"Patterson, George",4,Anfield
1415,1934-12-22,1934.0,Sunderland,Liverpool,2-3,2,3,1,1,5,-1,A,"Patterson, George",3,Away
1416,1934-12-26,1934.0,Liverpool,Middlesbrough,2-2,2,2,1,1,4,0,D,"Patterson, George",2,Anfield
1417,1934-12-29,1934.0,Blackburn Rovers,Liverpool,0-2,0,2,1,1,2,-2,A,"Patterson, George",2,Away
1418,1935-01-01,1934.0,Middlesbrough,Liverpool,2-0,2,0,1,1,2,2,H,"Patterson, George",0,Away
1419,1935-01-05,1934.0,Liverpool,Arsenal,0-2,0,2,1,1,2,-2,A,"Patterson, George",0,Anfield
1420,1935-01-19,1934.0,Portsmouth,Liverpool,1-2,1,2,1,1,3,-1,A,"Patterson, George",2,Away
1421,1935-02-02,1934.0,Liverpool,Leeds United,4-2,4,2,1,1,6,2,H,"Patterson, George",4,Anfield
1422,1935-02-09,1934.0,West Bromwich Albion,Liverpool,1-1,1,1,1,1,2,0,D,"Patterson, George",1,Away
1423,1935-02-20,1934.0,Liverpool,Sheffield Wednesday,1-2,1,2,1,1,3,-1,A,"Patterson, George",1,Anfield
1424,1935-02-23,1934.0,Birmingham City,Liverpool,1-3,1,3,1,1,4,-2,A,"Patterson, George",3,Away
1425,1935-03-02,1934.0,Grimsby Town,Liverpool,3-2,3,2,1,1,5,1,H,"Patterson, George",2,Away
1426,1935-03-09,1934.0,Liverpool,Preston North End,0-0,0,0,1,1,0,0,D,"Patterson, George",0,Anfield
1427,1935-03-16,1934.0,Wolverhampton Wanderers,Liverpool,5-3,5,3,1,1,8,2,H,"Patterson, George",3,Away
1428,1935-03-20,1934.0,Liverpool,Everton,2-1,2,1,1,1,3,1,H,"Patterson, George",2,Anfield
1429,1935-03-23,1934.0,Liverpool,Huddersfield Town,3-2,3,2,1,1,5,1,H,"Patterson, George",3,Anfield
1430,1935-03-30,1934.0,Leicester City,Liverpool,3-1,3,1,1,1,4,2,H,"Patterson, George",1,Away
1431,1935-04-06,1934.0,Liverpool,Derby County,1-3,1,3,1,1,4,-2,A,"Patterson, George",1,Anfield
1432,1935-04-13,1934.0,Aston Villa,Liverpool,4-2,4,2,1,1,6,2,H,"Patterson, George",2,Away
1433,1935-04-19,1934.0,Liverpool,Stoke City,5-0,5,0,1,1,5,5,H,"Patterson, George",5,Anfield
1434,1935-04-20,1934.0,Liverpool,Chelsea,6-0,6,0,1,1,6,6,H,"Patterson, George",6,Anfield
1435,1935-04-22,1934.0,Stoke City,Liverpool,1-1,1,1,1,1,2,0,D,"Patterson, George",1,Away
1436,1935-04-27,1934.0,Tottenham Hotspur,Liverpool,5-1,5,1,1,1,6,4,H,"Patterson, George",1,Away
1437,1935-05-04,1934.0,Liverpool,Sunderland,2-2,2,2,1,1,4,0,D,"Patterson, George",2,Anfield
1438,1935-08-31,1935.0,Chelsea,Liverpool,2-2,2,2,1,1,4,0,D,"Patterson, George",2,Away
1439,1935-09-04,1935.0,Liverpool,Manchester City,0-2,0,2,1,1,2,-2,A,"Patterson, George",0,Anfield
1440,1935-09-07,1935.0,Liverpool,Everton,6-0,6,0,1,1,6,6,H,"Patterson, George",6,Anfield
1441,1935-09-11,1935.0,Manchester City,Liverpool,6-0,6,0,1,1,6,6,H,"Patterson, George",0,Away
1442,1935-09-14,1935.0,Liverpool,Grimsby Town,7-2,7,2,1,1,9,5,H,"Patterson, George",7,Anfield
1443,1935-09-18,1935.0,Liverpool,Stoke City,2-0,2,0,1,1,2,2,H,"Patterson, George",2,Anfield
1444,1935-09-21,1935.0,Leeds United,Liverpool,1-0,1,0,1,1,1,1,H,"Patterson, George",0,Away
1445,1935-09-28,1935.0,Liverpool,West Bromwich Albion,5-0,5,0,1,1,5,5,H,"Patterson, George",5,Anfield
1446,1935-10-05,1935.0,Sunderland,Liverpool,2-0,2,0,1,1,2,2,H,"Patterson, George",0,Away
1447,1935-10-12,1935.0,Liverpool,Birmingham City,1-2,1,2,1,1,3,-1,A,"Patterson, George",1,Anfield
1448,1935-10-19,1935.0,Bolton Wanderers,Liverpool,0-0,0,0,1,1,0,0,D,"Patterson, George",0,Away
1449,1935-10-26,1935.0,Liverpool,Huddersfield Town,3-0,3,0,1,1,3,3,H,"Patterson, George",3,Anfield
1450,1935-11-02,1935.0,Middlesbrough,Liverpool,2-2,2,2,1,1,4,0,D,"Patterson, George",2,Away
1451,1935-11-09,1935.0,Liverpool,Aston Villa,3-2,3,2,1,1,5,1,H,"Patterson, George",3,Anfield
1452,1935-11-16,1935.0,Wolverhampton Wanderers,Liverpool,3-1,3,1,1,1,4,2,H,"Patterson, George",1,Away
1453,1935-11-23,1935.0,Liverpool,Derby County,0-0,0,0,1,1,0,0,D,"Patterson, George",0,Anfield
1454,1935-11-30,1935.0,Portsmouth,Liverpool,2-1,2,1,1,1,3,1,H,"Patterson, George",1,Away
1455,1935-12-07,1935.0,Liverpool,Preston North End,2-1,2,1,1,1,3,1,H,"Patterson, George",2,Anfield
1456,1935-12-14,1935.0,Brentford,Liverpool,1-2,1,2,1,1,3,-1,A,"Patterson, George",2,Away
1457,1935-12-21,1935.0,Liverpool,Sheffield Wednesday,1-0,1,0,1,1,1,1,H,"Patterson, George",1,Anfield
1458,1935-12-25,1935.0,Liverpool,Arsenal,0-1,0,1,1,1,1,-1,A,"Patterson, George",0,Anfield
1459,1935-12-26,1935.0,Arsenal,Liverpool,1-2,1,2,1,1,3,-1,A,"Patterson, George",2,Away
1460,1935-12-28,1935.0,Liverpool,Chelsea,2-3,2,3,1,1,5,-1,A,"Patterson, George",2,Anfield
1461,1936-01-04,1935.0,Everton,Liverpool,0-0,0,0,1,1,0,0,D,"Patterson, George",0,Away
1462,1936-01-18,1935.0,Grimsby Town,Liverpool,0-0,0,0,1,1,0,0,D,"Patterson, George",0,Away
1463,1936-02-01,1935.0,West Bromwich Albion,Liverpool,6-1,6,1,1,1,7,5,H,"Patterson, George",1,Away
1464,1936-02-08,1935.0,Liverpool,Sunderland,0-3,0,3,1,1,3,-3,A,"Patterson, George",0,Anfield
1465,1936-02-15,1935.0,Birmingham City,Liverpool,2-0,2,0,1,1,2,2,H,"Patterson, George",0,Away
1466,1936-02-22,1935.0,Liverpool,Bolton Wanderers,1-1,1,1,1,1,2,0,D,"Patterson, George",1,Anfield
1467,1936-02-29,1935.0,Aston Villa,Liverpool,3-0,3,0,1,1,3,3,H,"Patterson, George",0,Away
1468,1936-03-07,1935.0,Liverpool,Portsmouth,2-0,2,0,1,1,2,2,H,"Patterson, George",2,Anfield
1469,1936-03-14,1935.0,Huddersfield Town,Liverpool,1-0,1,0,1,1,1,1,H,"Patterson, George",0,Away
1470,1936-03-18,1935.0,Liverpool,Leeds United,2-1,2,1,1,1,3,1,H,"Patterson, George",2,Anfield
1471,1936-03-21,1935.0,Liverpool,Wolverhampton Wanderers,0-2,0,2,1,1,2,-2,A,"Patterson, George",0,Anfield
1472,1936-03-28,1935.0,Derby County,Liverpool,2-2,2,2,1,1,4,0,D,"Patterson, George",2,Away
1473,1936-04-04,1935.0,Liverpool,Middlesbrough,2-2,2,2,1,1,4,0,D,"Patterson, George",2,Anfield
1474,1936-04-10,1935.0,Blackburn Rovers,Liverpool,2-2,2,2,1,1,4,0,D,"Patterson, George",2,Away
1475,1936-04-11,1935.0,Preston North End,Liverpool,3-1,3,1,1,1,4,2,H,"Patterson, George",1,Away
1476,1936-04-13,1935.0,Liverpool,Blackburn Rovers,4-1,4,1,1,1,5,3,H,"Patterson, George",4,Anfield
1477,1936-04-18,1935.0,Liverpool,Brentford,0-0,0,0,1,1,0,0,D,"Patterson, George",0,Anfield
1478,1936-04-25,1935.0,Sheffield Wednesday,Liverpool,0-0,0,0,1,1,0,0,D,"Patterson, George",0,Away
1479,1936-05-02,1935.0,Stoke City,Liverpool,2-1,2,1,1,1,3,1,H,"Patterson, George",1,Away
1480,1936-08-29,1936.0,Liverpool,Stoke City,2-1,2,1,1,1,3,1,H,"Kay, George",2,Anfield
1481,1936-09-02,1936.0,Portsmouth,Liverpool,6-2,6,2,1,1,8,4,H,"Kay, George",2,Away
1482,1936-09-05,1936.0,Charlton Athletic,Liverpool,1-1,1,1,1,1,2,0,D,"Kay, George",1,Away
1483,1936-09-09,1936.0,Liverpool,Portsmouth,0-0,0,0,1,1,0,0,D,"Kay, George",0,Anfield
1484,1936-09-12,1936.0,Liverpool,Grimsby Town,7-1,7,1,1,1,8,6,H,"Kay, George",7,Anfield
1485,1936-09-16,1936.0,Chelsea,Liverpool,2-0,2,0,1,1,2,2,H,"Kay, George",0,Away
1486,1936-09-19,1936.0,Everton,Liverpool,2-0,2,0,1,1,2,2,H,"Kay, George",0,Away
1487,1936-09-26,1936.0,Leeds United,Liverpool,2-0,2,0,1,1,2,2,H,"Kay, George",0,Away
1488,1936-10-03,1936.0,Liverpool,Birmingham City,2-0,2,0,1,1,2,2,H,"Kay, George",2,Anfield
1489,1936-10-10,1936.0,Middlesbrough,Liverpool,3-3,3,3,1,1,6,0,D,"Kay, George",3,Away
1490,1936-10-17,1936.0,Liverpool,Bolton Wanderers,0-0,0,0,1,1,0,0,D,"Kay, George",0,Anfield
1491,1936-10-24,1936.0,Brentford,Liverpool,5-2,5,2,1,1,7,3,H,"Kay, George",2,Away
1492,1936-10-31,1936.0,Liverpool,Arsenal,2-1,2,1,1,1,3,1,H,"Kay, George",2,Anfield
1493,1936-11-07,1936.0,Preston North End,Liverpool,3-1,3,1,1,1,4,2,H,"Kay, George",1,Away
1494,1936-11-14,1936.0,Liverpool,Sheffield Wednesday,2-2,2,2,1,1,4,0,D,"Kay, George",2,Anfield
1495,1936-11-21,1936.0,Manchester United,Liverpool,2-5,2,5,1,1,7,-3,A,"Kay, George",5,Away
1496,1936-11-28,1936.0,Liverpool,Derby County,3-3,3,3,1,1,6,0,D,"Kay, George",3,Anfield
1497,1936-12-05,1936.0,Wolverhampton Wanderers,Liverpool,2-0,2,0,1,1,2,2,H,"Kay, George",0,Away
1498,1936-12-12,1936.0,Liverpool,Sunderland,4-0,4,0,1,1,4,4,H,"Kay, George",4,Anfield
1499,1936-12-19,1936.0,Huddersfield Town,Liverpool,4-0,4,0,1,1,4,4,H,"Kay, George",0,Away
1500,1936-12-25,1936.0,West Bromwich Albion,Liverpool,3-1,3,1,1,1,4,2,H,"Kay, George",1,Away
1501,1936-12-26,1936.0,Stoke City,Liverpool,1-1,1,1,1,1,2,0,D,"Kay, George",1,Away
1502,1936-12-28,1936.0,Liverpool,West Bromwich Albion,1-2,1,2,1,1,3,-1,A,"Kay, George",1,Anfield
1503,1937-01-02,1936.0,Liverpool,Charlton Athletic,1-2,1,2,1,1,3,-1,A,"Kay, George",1,Anfield
1504,1937-01-09,1936.0,Grimsby Town,Liverpool,2-1,2,1,1,1,3,1,H,"Kay, George",1,Away
1505,1937-01-23,1936.0,Liverpool,Everton,3-2,3,2,1,1,5,1,H,"Kay, George",3,Anfield
1506,1937-01-30,1936.0,Liverpool,Leeds United,3-0,3,0,1,1,3,3,H,"Kay, George",3,Anfield
1507,1937-02-06,1936.0,Birmingham City,Liverpool,5-0,5,0,1,1,5,5,H,"Kay, George",0,Away
1508,1937-02-13,1936.0,Liverpool,Middlesbrough,0-2,0,2,1,1,2,-2,A,"Kay, George",0,Anfield
1509,1937-02-24,1936.0,Bolton Wanderers,Liverpool,0-1,0,1,1,1,1,-1,A,"Kay, George",1,Away
1510,1937-02-27,1936.0,Liverpool,Brentford,2-2,2,2,1,1,4,0,D,"Kay, George",2,Anfield
1511,1937-03-10,1936.0,Arsenal,Liverpool,1-0,1,0,1,1,1,1,H,"Kay, George",0,Away
1512,1937-03-13,1936.0,Liverpool,Preston North End,1-1,1,1,1,1,2,0,D,"Kay, George",1,Anfield
1513,1937-03-20,1936.0,Sheffield Wednesday,Liverpool,1-2,1,2,1,1,3,-1,A,"Kay, George",2,Away
1514,1937-03-26,1936.0,Liverpool,Manchester City,0-5,0,5,1,1,5,-5,A,"Kay, George",0,Anfield
1515,1937-03-27,1936.0,Liverpool,Manchester United,2-0,2,0,1,1,2,2,H,"Kay, George",2,Anfield
1516,1937-03-29,1936.0,Manchester City,Liverpool,5-1,5,1,1,1,6,4,H,"Kay, George",1,Away
1517,1937-04-03,1936.0,Derby County,Liverpool,4-1,4,1,1,1,5,3,H,"Kay, George",1,Away
1518,1937-04-10,1936.0,Liverpool,Wolverhampton Wanderers,1-0,1,0,1,1,1,1,H,"Kay, George",1,Anfield
1519,1937-04-17,1936.0,Sunderland,Liverpool,4-2,4,2,1,1,6,2,H,"Kay, George",2,Away
1520,1937-04-24,1936.0,Liverpool,Huddersfield Town,1-1,1,1,1,1,2,0,D,"Kay, George",1,Anfield
1521,1937-05-01,1936.0,Liverpool,Chelsea,1-1,1,1,1,1,2,0,D,"Kay, George",1,Anfield
1522,1937-08-28,1937.0,Chelsea,Liverpool,6-1,6,1,1,1,7,5,H,"Kay, George",1,Away
1523,1937-09-01,1937.0,Liverpool,Portsmouth,3-2,3,2,1,1,5,1,H,"Kay, George",3,Anfield
1524,1937-09-04,1937.0,Liverpool,Charlton Athletic,1-2,1,2,1,1,3,-1,A,"Kay, George",1,Anfield
1525,1937-09-08,1937.0,Portsmouth,Liverpool,1-1,1,1,1,1,2,0,D,"Kay, George",1,Away
1526,1937-09-11,1937.0,Preston North End,Liverpool,4-1,4,1,1,1,5,3,H,"Kay, George",1,Away
1527,1937-09-15,1937.0,Liverpool,Stoke City,3-0,3,0,1,1,3,3,H,"Kay, George",3,Anfield
1528,1937-09-18,1937.0,Liverpool,Grimsby Town,2-1,2,1,1,1,3,1,H,"Kay, George",2,Anfield
1529,1937-09-25,1937.0,Leeds United,Liverpool,2-0,2,0,1,1,2,2,H,"Kay, George",0,Away
1530,1937-10-02,1937.0,Liverpool,Everton,1-2,1,2,1,1,3,-1,A,"Kay, George",1,Anfield
1531,1937-10-09,1937.0,Liverpool,West Bromwich Albion,0-1,0,1,1,1,1,-1,A,"Kay, George",0,Anfield
1532,1937-10-16,1937.0,Wolverhampton Wanderers,Liverpool,2-0,2,0,1,1,2,2,H,"Kay, George",0,Away
1533,1937-10-23,1937.0,Liverpool,Leicester City,1-1,1,1,1,1,2,0,D,"Kay, George",1,Anfield
1534,1937-10-30,1937.0,Sunderland,Liverpool,2-3,2,3,1,1,5,-1,A,"Kay, George",3,Away
1535,1937-11-06,1937.0,Liverpool,Brentford,3-4,3,4,1,1,7,-1,A,"Kay, George",3,Anfield
1536,1937-11-13,1937.0,Manchester City,Liverpool,1-3,1,3,1,1,4,-2,A,"Kay, George",3,Away
1537,1937-11-20,1937.0,Liverpool,Huddersfield Town,0-1,0,1,1,1,1,-1,A,"Kay, George",0,Anfield
1538,1937-11-27,1937.0,Blackpool,Liverpool,0-1,0,1,1,1,1,-1,A,"Kay, George",1,Away
1539,1937-12-04,1937.0,Liverpool,Derby County,3-4,3,4,1,1,7,-1,A,"Kay, George",3,Anfield
1540,1937-12-11,1937.0,Bolton Wanderers,Liverpool,0-0,0,0,1,1,0,0,D,"Kay, George",0,Away
1541,1937-12-18,1937.0,Liverpool,Arsenal,2-0,2,0,1,1,2,2,H,"Kay, George",2,Anfield
1542,1937-12-27,1937.0,Birmingham City,Liverpool,2-2,2,2,1,1,4,0,D,"Kay, George",2,Away
1543,1938-01-01,1937.0,Liverpool,Chelsea,2-2,2,2,1,1,4,0,D,"Kay, George",2,Anfield
1544,1938-01-15,1937.0,Charlton Athletic,Liverpool,3-0,3,0,1,1,3,3,H,"Kay, George",0,Away
1545,1938-01-29,1937.0,Grimsby Town,Liverpool,0-0,0,0,1,1,0,0,D,"Kay, George",0,Away
1546,1938-02-02,1937.0,Liverpool,Preston North End,2-2,2,2,1,1,4,0,D,"Kay, George",2,Anfield
1547,1938-02-05,1937.0,Liverpool,Leeds United,1-1,1,1,1,1,2,0,D,"Kay, George",1,Anfield
1548,1938-02-16,1937.0,Everton,Liverpool,1-3,1,3,1,1,4,-2,A,"Kay, George",3,Away
1549,1938-02-19,1937.0,West Bromwich Albion,Liverpool,5-1,5,1,1,1,6,4,H,"Kay, George",1,Away
1550,1938-02-26,1937.0,Liverpool,Wolverhampton Wanderers,0-1,0,1,1,1,1,-1,A,"Kay, George",0,Anfield
1551,1938-03-05,1937.0,Leicester City,Liverpool,2-2,2,2,1,1,4,0,D,"Kay, George",2,Away
1552,1938-03-12,1937.0,Liverpool,Sunderland,4-0,4,0,1,1,4,4,H,"Kay, George",4,Anfield
1553,1938-03-19,1937.0,Brentford,Liverpool,1-3,1,3,1,1,4,-2,A,"Kay, George",3,Away
1554,1938-03-26,1937.0,Liverpool,Manchester City,2-0,2,0,1,1,2,2,H,"Kay, George",2,Anfield
1555,1938-04-02,1937.0,Huddersfield Town,Liverpool,1-2,1,2,1,1,3,-1,A,"Kay, George",2,Away
1556,1938-04-06,1937.0,Liverpool,Birmingham City,3-2,3,2,1,1,5,1,H,"Kay, George",3,Anfield
1557,1938-04-09,1937.0,Liverpool,Blackpool,4-2,4,2,1,1,6,2,H,"Kay, George",4,Anfield
1558,1938-04-15,1937.0,Middlesbrough,Liverpool,1-1,1,1,1,1,2,0,D,"Kay, George",1,Away
1559,1938-04-16,1937.0,Derby County,Liverpool,4-1,4,1,1,1,5,3,H,"Kay, George",1,Away
1560,1938-04-18,1937.0,Liverpool,Middlesbrough,1-1,1,1,1,1,2,0,D,"Kay, George",1,Anfield
1561,1938-04-23,1937.0,Liverpool,Bolton Wanderers,2-1,2,1,1,1,3,1,H,"Kay, George",2,Anfield
1562,1938-04-30,1937.0,Arsenal,Liverpool,1-0,1,0,1,1,1,1,H,"Kay, George",0,Away
1563,1938-05-07,1937.0,Stoke City,Liverpool,2-0,2,0,1,1,2,2,H,"Kay, George",0,Away
1564,1938-08-27,1938.0,Liverpool,Chelsea,2-1,2,1,1,1,3,1,H,"Kay, George",2,Anfield
1565,1938-09-03,1938.0,Preston North End,Liverpool,1-0,1,0,1,1,1,1,H,"Kay, George",0,Away
1566,1938-09-07,1938.0,Liverpool,Manchester United,1-0,1,0,1,1,1,1,H,"Kay, George",1,Anfield
1567,1938-09-10,1938.0,Liverpool,Charlton Athletic,1-0,1,0,1,1,1,1,H,"Kay, George",1,Anfield
1568,1938-09-14,1938.0,Liverpool,Middlesbrough,3-1,3,1,1,1,4,2,H,"Kay, George",3,Anfield
1569,1938-09-17,1938.0,Bolton Wanderers,Liverpool,3-1,3,1,1,1,4,2,H,"Kay, George",1,Away
1570,1938-09-24,1938.0,Liverpool,Leeds United,3-0,3,0,1,1,3,3,H,"Kay, George",3,Anfield
1571,1938-10-01,1938.0,Everton,Liverpool,2-1,2,1,1,1,3,1,H,"Kay, George",1,Away
1572,1938-10-08,1938.0,Leicester City,Liverpool,2-2,2,2,1,1,4,0,D,"Kay, George",2,Away
1573,1938-10-15,1938.0,Liverpool,Aston Villa,3-0,3,0,1,1,3,3,H,"Kay, George",3,Anfield
1574,1938-10-22,1938.0,Wolverhampton Wanderers,Liverpool,2-2,2,2,1,1,4,0,D,"Kay, George",2,Away
1575,1938-10-29,1938.0,Liverpool,Huddersfield Town,3-3,3,3,1,1,6,0,D,"Kay, George",3,Anfield
1576,1938-11-05,1938.0,Portsmouth,Liverpool,1-1,1,1,1,1,2,0,D,"Kay, George",1,Away
1577,1938-11-12,1938.0,Liverpool,Arsenal,2-2,2,2,1,1,4,0,D,"Kay, George",2,Anfield
1578,1938-11-19,1938.0,Brentford,Liverpool,2-1,2,1,1,1,3,1,H,"Kay, George",1,Away
1579,1938-11-26,1938.0,Liverpool,Blackpool,1-0,1,0,1,1,1,1,H,"Kay, George",1,Anfield
1580,1938-12-03,1938.0,Derby County,Liverpool,2-2,2,2,1,1,4,0,D,"Kay, George",2,Away
1581,1938-12-10,1938.0,Liverpool,Grimsby Town,2-2,2,2,1,1,4,0,D,"Kay, George",2,Anfield
1582,1938-12-17,1938.0,Sunderland,Liverpool,2-3,2,3,1,1,5,-1,A,"Kay, George",3,Away
1583,1938-12-24,1938.0,Chelsea,Liverpool,4-1,4,1,1,1,5,3,H,"Kay, George",1,Away
1584,1938-12-26,1938.0,Stoke City,Liverpool,3-1,3,1,1,1,4,2,H,"Kay, George",1,Away
1585,1938-12-27,1938.0,Liverpool,Stoke City,1-0,1,0,1,1,1,1,H,"Kay, George",1,Anfield
1586,1938-12-31,1938.0,Liverpool,Preston North End,4-1,4,1,1,1,5,3,H,"Kay, George",4,Anfield
1587,1939-01-02,1938.0,Middlesbrough,Liverpool,3-0,3,0,1,1,3,3,H,"Kay, George",0,Away
1588,1939-01-14,1938.0,Charlton Athletic,Liverpool,1-3,1,3,1,1,4,-2,A,"Kay, George",3,Away
1589,1939-01-25,1938.0,Liverpool,Bolton Wanderers,1-2,1,2,1,1,3,-1,A,"Kay, George",1,Anfield
1590,1939-01-28,1938.0,Leeds United,Liverpool,1-1,1,1,1,1,2,0,D,"Kay, George",1,Away
1591,1939-02-04,1938.0,Liverpool,Everton,0-3,0,3,1,1,3,-3,A,"Kay, George",0,Anfield
1592,1939-02-18,1938.0,Aston Villa,Liverpool,2-0,2,0,1,1,2,2,H,"Kay, George",0,Away
1593,1939-02-25,1938.0,Liverpool,Wolverhampton Wanderers,0-2,0,2,1,1,2,-2,A,"Kay, George",0,Anfield
1594,1939-03-04,1938.0,Liverpool,Leicester City,1-1,1,1,1,1,2,0,D,"Kay, George",1,Anfield
1595,1939-03-11,1938.0,Liverpool,Portsmouth,4-4,4,4,1,1,8,0,D,"Kay, George",4,Anfield
1596,1939-03-15,1938.0,Huddersfield Town,Liverpool,1-1,1,1,1,1,2,0,D,"Kay, George",1,Away
1597,1939-03-18,1938.0,Arsenal,Liverpool,2-0,2,0,1,1,2,2,H,"Kay, George",0,Away
1598,1939-03-25,1938.0,Liverpool,Brentford,1-0,1,0,1,1,1,1,H,"Kay, George",1,Anfield
1599,1939-04-01,1938.0,Blackpool,Liverpool,1-1,1,1,1,1,2,0,D,"Kay, George",1,Away
1600,1939-04-07,1938.0,Liverpool,Birmingham City,4-0,4,0,1,1,4,4,H,"Kay, George",4,Anfield
1601,1939-04-08,1938.0,Liverpool,Derby County,2-1,2,1,1,1,3,1,H,"Kay, George",2,Anfield
1602,1939-04-10,1938.0,Birmingham City,Liverpool,0-0,0,0,1,1,0,0,D,"Kay, George",0,Away
1603,1939-04-15,1938.0,Grimsby Town,Liverpool,2-1,2,1,1,1,3,1,H,"Kay, George",1,Away
1604,1939-04-22,1938.0,Liverpool,Sunderland,1-1,1,1,1,1,2,0,D,"Kay, George",1,Anfield
1605,1939-05-06,1938.0,Manchester United,Liverpool,2-0,2,0,1,1,2,2,H,"Kay, George",0,Away
1606,1946-08-31,1946.0,Sheffield United,Liverpool,0-1,0,1,1,1,1,-1,A,"Kay, George",1,Away
1607,1946-09-04,1946.0,Liverpool,Middlesbrough,0-1,0,1,1,1,1,-1,A,"Kay, George",0,Anfield
1608,1946-09-07,1946.0,Liverpool,Chelsea,7-4,7,4,1,1,11,3,H,"Kay, George",7,Anfield
1609,1946-09-11,1946.0,Manchester United,Liverpool,5-0,5,0,1,1,5,5,H,"Kay, George",0,Away
1610,1946-09-14,1946.0,Bolton Wanderers,Liverpool,1-3,1,3,1,1,4,-2,A,"Kay, George",3,Away
1611,1946-09-21,1946.0,Liverpool,Everton,0-0,0,0,1,1,0,0,D,"Kay, George",0,Anfield
1612,1946-09-28,1946.0,Liverpool,Leeds United,2-0,2,0,1,1,2,2,H,"Kay, George",2,Anfield
1613,1946-10-05,1946.0,Grimsby Town,Liverpool,1-6,1,6,1,1,7,-5,A,"Kay, George",6,Away
1614,1946-10-09,1946.0,Middlesbrough,Liverpool,2-2,2,2,1,1,4,0,D,"Kay, George",2,Away
1615,1946-10-12,1946.0,Liverpool,Charlton Athletic,1-1,1,1,1,1,2,0,D,"Kay, George",1,Anfield
1616,1946-10-19,1946.0,Huddersfield Town,Liverpool,1-4,1,4,1,1,5,-3,A,"Kay, George",4,Away
1617,1946-10-26,1946.0,Liverpool,Brentford,1-0,1,0,1,1,1,1,H,"Kay, George",1,Anfield
1618,1946-11-02,1946.0,Blackburn Rovers,Liverpool,0-0,0,0,1,1,0,0,D,"Kay, George",0,Away
1619,1946-11-09,1946.0,Liverpool,Portsmouth,3-0,3,0,1,1,3,3,H,"Kay, George",3,Anfield
1620,1946-11-16,1946.0,Derby County,Liverpool,1-4,1,4,1,1,5,-3,A,"Kay, George",4,Away
1621,1946-11-23,1946.0,Liverpool,Arsenal,4-2,4,2,1,1,6,2,H,"Kay, George",4,Anfield
1622,1946-11-30,1946.0,Blackpool,Liverpool,3-2,3,2,1,1,5,1,H,"Kay, George",2,Away
1623,1946-12-07,1946.0,Liverpool,Wolverhampton Wanderers,1-5,1,5,1,1,6,-4,A,"Kay, George",1,Anfield
1624,1946-12-14,1946.0,Sunderland,Liverpool,1-4,1,4,1,1,5,-3,A,"Kay, George",4,Away
1625,1946-12-21,1946.0,Liverpool,Aston Villa,4-1,4,1,1,1,5,3,H,"Kay, George",4,Anfield
1626,1946-12-25,1946.0,Stoke City,Liverpool,2-1,2,1,1,1,3,1,H,"Kay, George",1,Away
1627,1946-12-26,1946.0,Liverpool,Stoke City,2-0,2,0,1,1,2,2,H,"Kay, George",2,Anfield
1628,1946-12-28,1946.0,Liverpool,Sheffield United,1-2,1,2,1,1,3,-1,A,"Kay, George",1,Anfield
1629,1947-01-04,1946.0,Chelsea,Liverpool,3-1,3,1,1,1,4,2,H,"Kay, George",1,Away
1630,1947-01-18,1946.0,Liverpool,Bolton Wanderers,0-3,0,3,1,1,3,-3,A,"Kay, George",0,Anfield
1631,1947-01-29,1946.0,Everton,Liverpool,1-0,1,0,1,1,1,1,H,"Kay, George",0,Away
1632,1947-02-01,1946.0,Leeds United,Liverpool,1-2,1,2,1,1,3,-1,A,"Kay, George",2,Away
1633,1947-02-12,1946.0,Liverpool,Grimsby Town,5-0,5,0,1,1,5,5,H,"Kay, George",5,Anfield
1634,1947-02-22,1946.0,Liverpool,Huddersfield Town,1-0,1,0,1,1,1,1,H,"Kay, George",1,Anfield
1635,1947-03-08,1946.0,Liverpool,Blackburn Rovers,2-1,2,1,1,1,3,1,H,"Kay, George",2,Anfield
1636,1947-03-15,1946.0,Portsmouth,Liverpool,1-2,1,2,1,1,3,-1,A,"Kay, George",2,Away
1637,1947-03-22,1946.0,Liverpool,Derby County,1-1,1,1,1,1,2,0,D,"Kay, George",1,Anfield
1638,1947-04-04,1946.0,Preston North End,Liverpool,0-0,0,0,1,1,0,0,D,"Kay, George",0,Away
1639,1947-04-05,1946.0,Liverpool,Blackpool,2-3,2,3,1,1,5,-1,A,"Kay, George",2,Anfield
1640,1947-04-07,1946.0,Liverpool,Preston North End,3-0,3,0,1,1,3,3,H,"Kay, George",3,Anfield
1641,1947-04-19,1946.0,Liverpool,Sunderland,1-0,1,0,1,1,1,1,H,"Kay, George",1,Anfield
1642,1947-04-26,1946.0,Aston Villa,Liverpool,1-2,1,2,1,1,3,-1,A,"Kay, George",2,Away
1643,1947-05-03,1946.0,Liverpool,Manchester United,1-0,1,0,1,1,1,1,H,"Kay, George",1,Anfield
1644,1947-05-10,1946.0,Charlton Athletic,Liverpool,1-3,1,3,1,1,4,-2,A,"Kay, George",3,Away
1645,1947-05-17,1946.0,Brentford,Liverpool,1-1,1,1,1,1,2,0,D,"Kay, George",1,Away
1646,1947-05-24,1946.0,Arsenal,Liverpool,1-2,1,2,1,1,3,-1,A,"Kay, George",2,Away
1647,1947-05-31,1946.0,Wolverhampton Wanderers,Liverpool,1-2,1,2,1,1,3,-1,A,"Kay, George",2,Away
1648,1947-08-23,1947.0,Liverpool,Preston North End,3-1,3,1,1,1,4,2,H,"Kay, George",3,Anfield
1649,1947-08-27,1947.0,Manchester United,Liverpool,2-0,2,0,1,1,2,2,H,"Kay, George",0,Away
1650,1947-08-30,1947.0,Stoke City,Liverpool,0-2,0,2,1,1,2,-2,A,"Kay, George",2,Away
1651,1947-09-03,1947.0,Liverpool,Manchester United,2-2,2,2,1,1,4,0,D,"Kay, George",2,Anfield
1652,1947-09-06,1947.0,Liverpool,Burnley,1-1,1,1,1,1,2,0,D,"Kay, George",1,Anfield
1653,1947-09-08,1947.0,Sheffield United,Liverpool,3-1,3,1,1,1,4,2,H,"Kay, George",1,Away
1654,1947-09-13,1947.0,Portsmouth,Liverpool,1-0,1,0,1,1,1,1,H,"Kay, George",0,Away
1655,1947-09-17,1947.0,Charlton Athletic,Liverpool,2-0,2,0,1,1,2,2,H,"Kay, George",0,Away
1656,1947-09-20,1947.0,Liverpool,Bolton Wanderers,0-0,0,0,1,1,0,0,D,"Kay, George",0,Anfield
1657,1947-09-27,1947.0,Everton,Liverpool,0-3,0,3,1,1,3,-3,A,"Kay, George",3,Away
1658,1947-10-04,1947.0,Middlesbrough,Liverpool,3-1,3,1,1,1,4,2,H,"Kay, George",1,Away
1659,1947-10-11,1947.0,Liverpool,Chelsea,3-0,3,0,1,1,3,3,H,"Kay, George",3,Anfield
1660,1947-10-18,1947.0,Huddersfield Town,Liverpool,1-1,1,1,1,1,2,0,D,"Kay, George",1,Away
1661,1947-10-25,1947.0,Liverpool,Derby County,2-2,2,2,1,1,4,0,D,"Kay, George",2,Anfield
1662,1947-11-01,1947.0,Blackpool,Liverpool,2-0,2,0,1,1,2,2,H,"Kay, George",0,Away
1663,1947-11-08,1947.0,Liverpool,Grimsby Town,3-1,3,1,1,1,4,2,H,"Kay, George",3,Anfield
1664,1947-11-15,1947.0,Sunderland,Liverpool,5-1,5,1,1,1,6,4,H,"Kay, George",1,Away
1665,1947-11-22,1947.0,Liverpool,Blackburn Rovers,2-1,2,1,1,1,3,1,H,"Kay, George",2,Anfield
1666,1947-11-29,1947.0,Manchester City,Liverpool,2-0,2,0,1,1,2,2,H,"Kay, George",0,Away
1667,1947-12-06,1947.0,Liverpool,Aston Villa,3-3,3,3,1,1,6,0,D,"Kay, George",3,Anfield
1668,1947-12-13,1947.0,Wolverhampton Wanderers,Liverpool,1-2,1,2,1,1,3,-1,A,"Kay, George",2,Away
1669,1947-12-20,1947.0,Preston North End,Liverpool,3-3,3,3,1,1,6,0,D,"Kay, George",3,Away
1670,1947-12-25,1947.0,Liverpool,Arsenal,1-3,1,3,1,1,4,-2,A,"Kay, George",1,Anfield
1671,1947-12-27,1947.0,Arsenal,Liverpool,1-2,1,2,1,1,3,-1,A,"Kay, George",2,Away
1672,1948-01-01,1947.0,Liverpool,Charlton Athletic,2-3,2,3,1,1,5,-1,A,"Kay, George",2,Anfield
1673,1948-01-03,1947.0,Liverpool,Stoke City,0-0,0,0,1,1,0,0,D,"Kay, George",0,Anfield
1674,1948-01-17,1947.0,Burnley,Liverpool,3-0,3,0,1,1,3,3,H,"Kay, George",0,Away
1675,1948-01-31,1947.0,Liverpool,Portsmouth,0-3,0,3,1,1,3,-3,A,"Kay, George",0,Anfield
1676,1948-02-07,1947.0,Bolton Wanderers,Liverpool,3-0,3,0,1,1,3,3,H,"Kay, George",0,Away
1677,1948-02-21,1947.0,Liverpool,Middlesbrough,0-1,0,1,1,1,1,-1,A,"Kay, George",0,Anfield
1678,1948-02-28,1947.0,Chelsea,Liverpool,3-1,3,1,1,1,4,2,H,"Kay, George",1,Away
1679,1948-03-06,1947.0,Liverpool,Huddersfield Town,4-0,4,0,1,1,4,4,H,"Kay, George",4,Anfield
1680,1948-03-20,1947.0,Liverpool,Blackpool,2-0,2,0,1,1,2,2,H,"Kay, George",2,Anfield
1681,1948-03-26,1947.0,Liverpool,Sheffield United,4-0,4,0,1,1,4,4,H,"Kay, George",4,Anfield
1682,1948-03-27,1947.0,Grimsby Town,Liverpool,0-2,0,2,1,1,2,-2,A,"Kay, George",2,Away
1683,1948-03-31,1947.0,Derby County,Liverpool,0-4,0,4,1,1,4,-4,A,"Kay, George",4,Away
1684,1948-04-03,1947.0,Liverpool,Sunderland,0-0,0,0,1,1,0,0,D,"Kay, George",0,Anfield
1685,1948-04-10,1947.0,Blackburn Rovers,Liverpool,1-2,1,2,1,1,3,-1,A,"Kay, George",2,Away
1686,1948-04-17,1947.0,Liverpool,Manchester City,1-1,1,1,1,1,2,0,D,"Kay, George",1,Anfield
1687,1948-04-21,1947.0,Liverpool,Everton,4-0,4,0,1,1,4,4,H,"Kay, George",4,Anfield
1688,1948-04-24,1947.0,Aston Villa,Liverpool,2-1,2,1,1,1,3,1,H,"Kay, George",1,Away
1689,1948-05-01,1947.0,Liverpool,Wolverhampton Wanderers,2-1,2,1,1,1,3,1,H,"Kay, George",2,Anfield
1690,1948-08-21,1948.0,Aston Villa,Liverpool,2-1,2,1,1,1,3,1,H,"Kay, George",1,Away
1691,1948-08-25,1948.0,Liverpool,Sheffield United,3-3,3,3,1,1,6,0,D,"Kay, George",3,Anfield
1692,1948-08-28,1948.0,Liverpool,Sunderland,4-0,4,0,1,1,4,4,H,"Kay, George",4,Anfield
1693,1948-08-30,1948.0,Sheffield United,Liverpool,1-2,1,2,1,1,3,-1,A,"Kay, George",2,Away
1694,1948-09-04,1948.0,Wolverhampton Wanderers,Liverpool,0-0,0,0,1,1,0,0,D,"Kay, George",0,Away
1695,1948-09-08,1948.0,Arsenal,Liverpool,1-1,1,1,1,1,2,0,D,"Kay, George",1,Away
1696,1948-09-11,1948.0,Liverpool,Bolton Wanderers,0-1,0,1,1,1,1,-1,A,"Kay, George",0,Anfield
1697,1948-09-15,1948.0,Liverpool,Arsenal,0-1,0,1,1,1,1,-1,A,"Kay, George",0,Anfield
1698,1948-09-18,1948.0,Everton,Liverpool,1-1,1,1,1,1,2,0,D,"Kay, George",1,Away
1699,1948-09-25,1948.0,Blackpool,Liverpool,1-0,1,0,1,1,1,1,H,"Kay, George",0,Away
1700,1948-10-02,1948.0,Liverpool,Derby County,0-0,0,0,1,1,0,0,D,"Kay, George",0,Anfield
1701,1948-10-09,1948.0,Liverpool,Chelsea,1-1,1,1,1,1,2,0,D,"Kay, George",1,Anfield
1702,1948-10-16,1948.0,Birmingham City,Liverpool,0-1,0,1,1,1,1,-1,A,"Kay, George",1,Away
1703,1948-10-23,1948.0,Liverpool,Middlesbrough,4-0,4,0,1,1,4,4,H,"Kay, George",4,Anfield
1704,1948-10-30,1948.0,Newcastle United,Liverpool,1-0,1,0,1,1,1,1,H,"Kay, George",0,Away
1705,1948-11-06,1948.0,Liverpool,Portsmouth,3-1,3,1,1,1,4,2,H,"Kay, George",3,Anfield
1706,1948-11-13,1948.0,Manchester City,Liverpool,2-4,2,4,1,1,6,-2,A,"Kay, George",4,Away
1707,1948-11-20,1948.0,Liverpool,Charlton Athletic,1-1,1,1,1,1,2,0,D,"Kay, George",1,Anfield
1708,1948-11-27,1948.0,Stoke City,Liverpool,3-0,3,0,1,1,3,3,H,"Kay, George",0,Away
1709,1948-12-04,1948.0,Liverpool,Burnley,1-1,1,1,1,1,2,0,D,"Kay, George",1,Anfield
1710,1948-12-11,1948.0,Preston North End,Liverpool,3-2,3,2,1,1,5,1,H,"Kay, George",2,Away
1711,1948-12-18,1948.0,Liverpool,Aston Villa,1-1,1,1,1,1,2,0,D,"Kay, George",1,Anfield
1712,1948-12-25,1948.0,Manchester United,Liverpool,0-0,0,0,1,1,0,0,D,"Kay, George",0,Away
1713,1948-12-27,1948.0,Liverpool,Manchester United,0-2,0,2,1,1,2,-2,A,"Kay, George",0,Anfield
1714,1949-01-01,1948.0,Sunderland,Liverpool,0-2,0,2,1,1,2,-2,A,"Kay, George",2,Away
1715,1949-01-22,1948.0,Bolton Wanderers,Liverpool,0-3,0,3,1,1,3,-3,A,"Kay, George",3,Away
1716,1949-02-05,1948.0,Liverpool,Everton,0-0,0,0,1,1,0,0,D,"Kay, George",0,Anfield
1717,1949-02-19,1948.0,Liverpool,Blackpool,1-1,1,1,1,1,2,0,D,"Kay, George",1,Anfield
1718,1949-03-05,1948.0,Chelsea,Liverpool,2-1,2,1,1,1,3,1,H,"Kay, George",1,Away
1719,1949-03-12,1948.0,Liverpool,Birmingham City,1-0,1,0,1,1,1,1,H,"Kay, George",1,Anfield
1720,1949-03-19,1948.0,Charlton Athletic,Liverpool,2-1,2,1,1,1,3,1,H,"Kay, George",1,Away
1721,1949-03-26,1948.0,Liverpool,Stoke City,4-0,4,0,1,1,4,4,H,"Kay, George",4,Anfield
1722,1949-04-02,1948.0,Portsmouth,Liverpool,3-2,3,2,1,1,5,1,H,"Kay, George",2,Away
1723,1949-04-06,1948.0,Liverpool,Wolverhampton Wanderers,0-0,0,0,1,1,0,0,D,"Kay, George",0,Anfield
1724,1949-04-09,1948.0,Liverpool,Manchester City,0-1,0,1,1,1,1,-1,A,"Kay, George",0,Anfield
1725,1949-04-15,1948.0,Liverpool,Huddersfield Town,0-1,0,1,1,1,1,-1,A,"Kay, George",0,Anfield
1726,1949-04-16,1948.0,Middlesbrough,Liverpool,0-1,0,1,1,1,1,-1,A,"Kay, George",1,Away
1727,1949-04-18,1948.0,Huddersfield Town,Liverpool,0-4,0,4,1,1,4,-4,A,"Kay, George",4,Away
1728,1949-04-23,1948.0,Liverpool,Newcastle United,1-1,1,1,1,1,2,0,D,"Kay, George",1,Anfield
1729,1949-04-30,1948.0,Burnley,Liverpool,0-2,0,2,1,1,2,-2,A,"Kay, George",2,Away
1730,1949-05-04,1948.0,Derby County,Liverpool,3-0,3,0,1,1,3,3,H,"Kay, George",0,Away
1731,1949-05-07,1948.0,Liverpool,Preston North End,0-2,0,2,1,1,2,-2,A,"Kay, George",0,Anfield
1732,1949-08-20,1949.0,Liverpool,Sunderland,4-2,4,2,1,1,6,2,H,"Kay, George",4,Anfield
1733,1949-08-22,1949.0,Stoke City,Liverpool,0-0,0,0,1,1,0,0,D,"Kay, George",0,Away
1734,1949-08-27,1949.0,Everton,Liverpool,0-0,0,0,1,1,0,0,D,"Kay, George",0,Away
1735,1949-08-31,1949.0,Liverpool,Stoke City,1-1,1,1,1,1,2,0,D,"Kay, George",1,Anfield
1736,1949-09-03,1949.0,Arsenal,Liverpool,1-2,1,2,1,1,3,-1,A,"Kay, George",2,Away
1737,1949-09-07,1949.0,Liverpool,Manchester United,1-1,1,1,1,1,2,0,D,"Kay, George",1,Anfield
1738,1949-09-10,1949.0,Liverpool,Bolton Wanderers,1-1,1,1,1,1,2,0,D,"Kay, George",1,Anfield
1739,1949-09-17,1949.0,Birmingham City,Liverpool,2-3,2,3,1,1,5,-1,A,"Kay, George",3,Away
1740,1949-09-24,1949.0,Liverpool,Derby County,3-1,3,1,1,1,4,2,H,"Kay, George",3,Anfield
1741,1949-10-01,1949.0,West Bromwich Albion,Liverpool,0-1,0,1,1,1,1,-1,A,"Kay, George",1,Away
1742,1949-10-08,1949.0,Liverpool,Middlesbrough,2-0,2,0,1,1,2,2,H,"Kay, George",2,Anfield
1743,1949-10-15,1949.0,Blackpool,Liverpool,0-0,0,0,1,1,0,0,D,"Kay, George",0,Away
1744,1949-10-22,1949.0,Liverpool,Newcastle United,2-2,2,2,1,1,4,0,D,"Kay, George",2,Anfield
1745,1949-10-29,1949.0,Fulham,Liverpool,0-1,0,1,1,1,1,-1,A,"Kay, George",1,Away
1746,1949-11-05,1949.0,Liverpool,Manchester City,4-0,4,0,1,1,4,4,H,"Kay, George",4,Anfield
1747,1949-11-12,1949.0,Charlton Athletic,Liverpool,1-3,1,3,1,1,4,-2,A,"Kay, George",3,Away
1748,1949-11-19,1949.0,Liverpool,Aston Villa,2-1,2,1,1,1,3,1,H,"Kay, George",2,Anfield
1749,1949-11-26,1949.0,Wolverhampton Wanderers,Liverpool,1-1,1,1,1,1,2,0,D,"Kay, George",1,Away
1750,1949-12-03,1949.0,Liverpool,Portsmouth,2-2,2,2,1,1,4,0,D,"Kay, George",2,Anfield
1751,1949-12-10,1949.0,Huddersfield Town,Liverpool,3-2,3,2,1,1,5,1,H,"Kay, George",2,Away
1752,1949-12-17,1949.0,Sunderland,Liverpool,3-2,3,2,1,1,5,1,H,"Kay, George",2,Away
1753,1949-12-24,1949.0,Liverpool,Everton,3-1,3,1,1,1,4,2,H,"Kay, George",3,Anfield
1754,1949-12-26,1949.0,Chelsea,Liverpool,1-1,1,1,1,1,2,0,D,"Kay, George",1,Away
1755,1949-12-27,1949.0,Liverpool,Chelsea,2-2,2,2,1,1,4,0,D,"Kay, George",2,Anfield
1756,1949-12-31,1949.0,Liverpool,Arsenal,2-0,2,0,1,1,2,2,H,"Kay, George",2,Anfield
1757,1950-01-14,1949.0,Bolton Wanderers,Liverpool,3-2,3,2,1,1,5,1,H,"Kay, George",2,Away
1758,1950-01-21,1949.0,Liverpool,Birmingham City,2-0,2,0,1,1,2,2,H,"Kay, George",2,Anfield
1759,1950-02-04,1949.0,Derby County,Liverpool,2-2,2,2,1,1,4,0,D,"Kay, George",2,Away
1760,1950-02-18,1949.0,Liverpool,West Bromwich Albion,2-1,2,1,1,1,3,1,H,"Kay, George",2,Anfield
1761,1950-02-25,1949.0,Middlesbrough,Liverpool,4-1,4,1,1,1,5,3,H,"Kay, George",1,Away
1762,1950-03-08,1949.0,Liverpool,Blackpool,0-1,0,1,1,1,1,-1,A,"Kay, George",0,Anfield
1763,1950-03-11,1949.0,Aston Villa,Liverpool,2-0,2,0,1,1,2,2,H,"Kay, George",0,Away
1764,1950-03-15,1949.0,Manchester United,Liverpool,0-0,0,0,1,1,0,0,D,"Kay, George",0,Away
1765,1950-03-18,1949.0,Liverpool,Wolverhampton Wanderers,0-2,0,2,1,1,2,-2,A,"Kay, George",0,Anfield
1766,1950-03-29,1949.0,Manchester City,Liverpool,1-2,1,2,1,1,3,-1,A,"Kay, George",2,Away
1767,1950-04-01,1949.0,Liverpool,Charlton Athletic,1-0,1,0,1,1,1,1,H,"Kay, George",1,Anfield
1768,1950-04-07,1949.0,Burnley,Liverpool,0-2,0,2,1,1,2,-2,A,"Kay, George",2,Away
1769,1950-04-08,1949.0,Newcastle United,Liverpool,5-1,5,1,1,1,6,4,H,"Kay, George",1,Away
1770,1950-04-10,1949.0,Liverpool,Burnley,0-1,0,1,1,1,1,-1,A,"Kay, George",0,Anfield
1771,1950-04-15,1949.0,Liverpool,Fulham,1-1,1,1,1,1,2,0,D,"Kay, George",1,Anfield
1772,1950-04-22,1949.0,Portsmouth,Liverpool,2-1,2,1,1,1,3,1,H,"Kay, George",1,Away
1773,1950-05-03,1949.0,Liverpool,Huddersfield Town,2-3,2,3,1,1,5,-1,A,"Kay, George",2,Anfield
1774,1950-08-19,1950.0,Wolverhampton Wanderers,Liverpool,2-0,2,0,1,1,2,2,H,"Kay, George",0,Away
1775,1950-08-23,1950.0,Liverpool,Manchester United,2-1,2,1,1,1,3,1,H,"Kay, George",2,Anfield
1776,1950-08-26,1950.0,Liverpool,Sunderland,4-0,4,0,1,1,4,4,H,"Kay, George",4,Anfield
1777,1950-08-30,1950.0,Manchester United,Liverpool,1-0,1,0,1,1,1,1,H,"Kay, George",0,Away
1778,1950-09-02,1950.0,Aston Villa,Liverpool,1-1,1,1,1,1,2,0,D,"Kay, George",1,Away
1779,1950-09-06,1950.0,Liverpool,Tottenham Hotspur,2-1,2,1,1,1,3,1,H,"Kay, George",2,Anfield
1780,1950-09-09,1950.0,Liverpool,Derby County,1-0,1,0,1,1,1,1,H,"Kay, George",1,Anfield
1781,1950-09-16,1950.0,Everton,Liverpool,1-3,1,3,1,1,4,-2,A,"Kay, George",3,Away
1782,1950-09-23,1950.0,Fulham,Liverpool,2-1,2,1,1,1,3,1,H,"Kay, George",1,Away
1783,1950-09-30,1950.0,Liverpool,Bolton Wanderers,3-3,3,3,1,1,6,0,D,"Kay, George",3,Anfield
1784,1950-10-07,1950.0,Liverpool,Stoke City,0-0,0,0,1,1,0,0,D,"Kay, George",0,Anfield
1785,1950-10-14,1950.0,West Bromwich Albion,Liverpool,1-1,1,1,1,1,2,0,D,"Kay, George",1,Away
1786,1950-10-21,1950.0,Liverpool,Middlesbrough,0-0,0,0,1,1,0,0,D,"Kay, George",0,Anfield
1787,1950-10-28,1950.0,Sheffield Wednesday,Liverpool,4-1,4,1,1,1,5,3,H,"Kay, George",1,Away
1788,1950-11-04,1950.0,Liverpool,Newcastle United,2-4,2,4,1,1,6,-2,A,"Kay, George",2,Anfield
1789,1950-11-11,1950.0,Huddersfield Town,Liverpool,2-2,2,2,1,1,4,0,D,"Kay, George",2,Away
1790,1950-11-18,1950.0,Liverpool,Arsenal,1-3,1,3,1,1,4,-2,A,"Kay, George",1,Anfield
1791,1950-11-25,1950.0,Burnley,Liverpool,1-1,1,1,1,1,2,0,D,"Kay, George",1,Away
1792,1950-12-02,1950.0,Liverpool,Chelsea,1-0,1,0,1,1,1,1,H,"Kay, George",1,Anfield
1793,1950-12-09,1950.0,Portsmouth,Liverpool,1-3,1,3,1,1,4,-2,A,"Kay, George",3,Away
1794,1950-12-16,1950.0,Liverpool,Wolverhampton Wanderers,1-4,1,4,1,1,5,-3,A,"Kay, George",1,Anfield
1795,1950-12-23,1950.0,Sunderland,Liverpool,2-1,2,1,1,1,3,1,H,"Kay, George",1,Away
1796,1950-12-25,1950.0,Blackpool,Liverpool,3-0,3,0,1,1,3,3,H,"Kay, George",0,Away
1797,1950-12-26,1950.0,Liverpool,Blackpool,1-0,1,0,1,1,1,1,H,"Kay, George",1,Anfield
1798,1951-01-13,1950.0,Derby County,Liverpool,1-2,1,2,1,1,3,-1,A,"Kay, George",2,Away
1799,1951-01-20,1950.0,Liverpool,Everton,0-2,0,2,1,1,2,-2,A,"Kay, George",0,Anfield
1800,1951-01-27,1950.0,Charlton Athletic,Liverpool,1-0,1,0,1,1,1,1,H,"Kay, George",0,Away
1801,1951-02-03,1950.0,Liverpool,Fulham,2-0,2,0,1,1,2,2,H,"Kay, George",2,Anfield
1802,1951-02-10,1950.0,Liverpool,Portsmouth,2-1,2,1,1,1,3,1,H,"Kay, George",2,Anfield
1803,1951-02-17,1950.0,Bolton Wanderers,Liverpool,2-1,2,1,1,1,3,1,H,"Kay, George",1,Away
1804,1951-02-24,1950.0,Stoke City,Liverpool,2-3,2,3,1,1,5,-1,A,"Kay, George",3,Away
1805,1951-03-03,1950.0,Liverpool,West Bromwich Albion,1-1,1,1,1,1,2,0,D,"Kay, George",1,Anfield
1806,1951-03-10,1950.0,Middlesbrough,Liverpool,1-1,1,1,1,1,2,0,D,"Kay, George",1,Away
1807,1951-03-17,1950.0,Liverpool,Sheffield Wednesday,2-1,2,1,1,1,3,1,H,"Kay, George",2,Anfield
1808,1951-03-23,1950.0,Liverpool,Charlton Athletic,1-0,1,0,1,1,1,1,H,"Welsh, Don",1,Anfield
1809,1951-03-24,1950.0,Newcastle United,Liverpool,1-1,1,1,1,1,2,0,D,"Welsh, Don",1,Away
1810,1951-03-31,1950.0,Liverpool,Huddersfield Town,1-4,1,4,1,1,5,-3,A,"Welsh, Don",1,Anfield
1811,1951-04-07,1950.0,Arsenal,Liverpool,1-2,1,2,1,1,3,-1,A,"Welsh, Don",2,Away
1812,1951-04-14,1950.0,Liverpool,Burnley,1-0,1,0,1,1,1,1,H,"Welsh, Don",1,Anfield
1813,1951-04-21,1950.0,Chelsea,Liverpool,1-0,1,0,1,1,1,1,H,"Welsh, Don",0,Away
1814,1951-04-25,1950.0,Liverpool,Aston Villa,0-0,0,0,1,1,0,0,D,"Welsh, Don",0,Anfield
1815,1951-05-05,1950.0,Tottenham Hotspur,Liverpool,3-1,3,1,1,1,4,2,H,"Welsh, Don",1,Away
1816,1951-08-18,1951.0,Liverpool,Portsmouth,0-2,0,2,1,1,2,-2,A,"Welsh, Don",0,Anfield
1817,1951-08-21,1951.0,Burnley,Liverpool,0-0,0,0,1,1,0,0,D,"Welsh, Don",0,Away
1818,1951-08-25,1951.0,Chelsea,Liverpool,1-3,1,3,1,1,4,-2,A,"Welsh, Don",3,Away
1819,1951-08-29,1951.0,Liverpool,Burnley,3-1,3,1,1,1,4,2,H,"Welsh, Don",3,Anfield
1820,1951-09-01,1951.0,Liverpool,Huddersfield Town,2-1,2,1,1,1,3,1,H,"Welsh, Don",2,Anfield
1821,1951-09-05,1951.0,Arsenal,Liverpool,0-0,0,0,1,1,0,0,D,"Welsh, Don",0,Away
1822,1951-09-08,1951.0,Wolverhampton Wanderers,Liverpool,2-1,2,1,1,1,3,1,H,"Welsh, Don",1,Away
1823,1951-09-12,1951.0,Liverpool,Arsenal,0-0,0,0,1,1,0,0,D,"Welsh, Don",0,Anfield
1824,1951-09-15,1951.0,Liverpool,Sunderland,2-2,2,2,1,1,4,0,D,"Welsh, Don",2,Anfield
1825,1951-09-22,1951.0,Aston Villa,Liverpool,2-0,2,0,1,1,2,2,H,"Welsh, Don",0,Away
1826,1951-09-29,1951.0,Liverpool,Derby County,2-0,2,0,1,1,2,2,H,"Welsh, Don",2,Anfield
1827,1951-10-06,1951.0,Charlton Athletic,Liverpool,2-0,2,0,1,1,2,2,H,"Welsh, Don",0,Away
1828,1951-10-13,1951.0,Liverpool,Fulham,4-0,4,0,1,1,4,4,H,"Welsh, Don",4,Anfield
1829,1951-10-20,1951.0,Middlesbrough,Liverpool,3-3,3,3,1,1,6,0,D,"Welsh, Don",3,Away
1830,1951-10-27,1951.0,Liverpool,West Bromwich Albion,2-5,2,5,1,1,7,-3,A,"Welsh, Don",2,Anfield
1831,1951-11-03,1951.0,Newcastle United,Liverpool,1-1,1,1,1,1,2,0,D,"Welsh, Don",1,Away
1832,1951-11-10,1951.0,Liverpool,Bolton Wanderers,1-1,1,1,1,1,2,0,D,"Welsh, Don",1,Anfield
1833,1951-11-17,1951.0,Stoke City,Liverpool,1-2,1,2,1,1,3,-1,A,"Welsh, Don",2,Away
1834,1951-11-24,1951.0,Liverpool,Manchester United,0-0,0,0,1,1,0,0,D,"Welsh, Don",0,Anfield
1835,1951-12-01,1951.0,Tottenham Hotspur,Liverpool,2-3,2,3,1,1,5,-1,A,"Welsh, Don",3,Away
1836,1951-12-08,1951.0,Liverpool,Preston North End,2-2,2,2,1,1,4,0,D,"Welsh, Don",2,Anfield
1837,1951-12-15,1951.0,Portsmouth,Liverpool,1-3,1,3,1,1,4,-2,A,"Welsh, Don",3,Away
1838,1951-12-22,1951.0,Liverpool,Chelsea,1-1,1,1,1,1,2,0,D,"Welsh, Don",1,Anfield
1839,1951-12-25,1951.0,Liverpool,Blackpool,1-1,1,1,1,1,2,0,D,"Welsh, Don",1,Anfield
1840,1951-12-26,1951.0,Blackpool,Liverpool,2-0,2,0,1,1,2,2,H,"Welsh, Don",0,Away
1841,1951-12-29,1951.0,Huddersfield Town,Liverpool,1-2,1,2,1,1,3,-1,A,"Welsh, Don",2,Away
1842,1952-01-05,1951.0,Liverpool,Wolverhampton Wanderers,1-1,1,1,1,1,2,0,D,"Welsh, Don",1,Anfield
1843,1952-01-19,1951.0,Sunderland,Liverpool,3-0,3,0,1,1,3,3,H,"Welsh, Don",0,Away
1844,1952-01-26,1951.0,Liverpool,Aston Villa,1-2,1,2,1,1,3,-1,A,"Welsh, Don",1,Anfield
1845,1952-02-09,1951.0,Derby County,Liverpool,1-1,1,1,1,1,2,0,D,"Welsh, Don",1,Away
1846,1952-02-16,1951.0,Liverpool,Charlton Athletic,1-1,1,1,1,1,2,0,D,"Welsh, Don",1,Anfield
1847,1952-03-01,1951.0,Fulham,Liverpool,1-1,1,1,1,1,2,0,D,"Welsh, Don",1,Away
1848,1952-03-08,1951.0,Liverpool,Middlesbrough,1-1,1,1,1,1,2,0,D,"Welsh, Don",1,Anfield
1849,1952-03-15,1951.0,West Bromwich Albion,Liverpool,3-3,3,3,1,1,6,0,D,"Welsh, Don",3,Away
1850,1952-03-22,1951.0,Liverpool,Newcastle United,3-0,3,0,1,1,3,3,H,"Welsh, Don",3,Anfield
1851,1952-03-29,1951.0,Bolton Wanderers,Liverpool,1-1,1,1,1,1,2,0,D,"Welsh, Don",1,Away
1852,1952-04-05,1951.0,Liverpool,Stoke City,2-1,2,1,1,1,3,1,H,"Welsh, Don",2,Anfield
1853,1952-04-11,1951.0,Manchester City,Liverpool,1-2,1,2,1,1,3,-1,A,"Welsh, Don",2,Away
1854,1952-04-12,1951.0,Manchester United,Liverpool,4-0,4,0,1,1,4,4,H,"Welsh, Don",0,Away
1855,1952-04-14,1951.0,Liverpool,Manchester City,1-2,1,2,1,1,3,-1,A,"Welsh, Don",1,Anfield
1856,1952-04-19,1951.0,Liverpool,Tottenham Hotspur,1-1,1,1,1,1,2,0,D,"Welsh, Don",1,Anfield
1857,1952-04-26,1951.0,Preston North End,Liverpool,4-0,4,0,1,1,4,4,H,"Welsh, Don",0,Away
1858,1952-08-23,1952.0,Preston North End,Liverpool,1-1,1,1,1,1,2,0,D,"Welsh, Don",1,Away
1859,1952-08-27,1952.0,Liverpool,Sheffield Wednesday,1-0,1,0,1,1,1,1,H,"Welsh, Don",1,Anfield
1860,1952-08-30,1952.0,Liverpool,Stoke City,3-2,3,2,1,1,5,1,H,"Welsh, Don",3,Anfield
1861,1952-09-03,1952.0,Sheffield Wednesday,Liverpool,0-2,0,2,1,1,2,-2,A,"Welsh, Don",2,Away
1862,1952-09-06,1952.0,Manchester City,Liverpool,0-2,0,2,1,1,2,-2,A,"Welsh, Don",2,Away
1863,1952-09-10,1952.0,Liverpool,Tottenham Hotspur,2-1,2,1,1,1,3,1,H,"Welsh, Don",2,Anfield
1864,1952-09-13,1952.0,Liverpool,Portsmouth,1-1,1,1,1,1,2,0,D,"Welsh, Don",1,Anfield
1865,1952-09-15,1952.0,Tottenham Hotspur,Liverpool,3-1,3,1,1,1,4,2,H,"Welsh, Don",1,Away
1866,1952-09-20,1952.0,Liverpool,Middlesbrough,4-1,4,1,1,1,5,3,H,"Welsh, Don",4,Anfield
1867,1952-09-27,1952.0,West Bromwich Albion,Liverpool,3-0,3,0,1,1,3,3,H,"Welsh, Don",0,Away
1868,1952-10-04,1952.0,Liverpool,Newcastle United,5-3,5,3,1,1,8,2,H,"Welsh, Don",5,Anfield
1869,1952-10-11,1952.0,Bolton Wanderers,Liverpool,2-2,2,2,1,1,4,0,D,"Welsh, Don",2,Away
1870,1952-10-18,1952.0,Liverpool,Aston Villa,0-2,0,2,1,1,2,-2,A,"Welsh, Don",0,Anfield
1871,1952-10-25,1952.0,Sunderland,Liverpool,3-1,3,1,1,1,4,2,H,"Welsh, Don",1,Away
1872,1952-11-01,1952.0,Liverpool,Wolverhampton Wanderers,2-1,2,1,1,1,3,1,H,"Welsh, Don",2,Anfield
1873,1952-11-08,1952.0,Charlton Athletic,Liverpool,3-2,3,2,1,1,5,1,H,"Welsh, Don",2,Away
1874,1952-11-15,1952.0,Liverpool,Arsenal,1-5,1,5,1,1,6,-4,A,"Welsh, Don",1,Anfield
1875,1952-11-22,1952.0,Derby County,Liverpool,3-2,3,2,1,1,5,1,H,"Welsh, Don",2,Away
1876,1952-11-29,1952.0,Liverpool,Blackpool,2-2,2,2,1,1,4,0,D,"Welsh, Don",2,Anfield
1877,1952-12-13,1952.0,Liverpool,Manchester United,1-2,1,2,1,1,3,-1,A,"Welsh, Don",1,Anfield
1878,1952-12-20,1952.0,Liverpool,Preston North End,2-2,2,2,1,1,4,0,D,"Welsh, Don",2,Anfield
1879,1952-12-25,1952.0,Burnley,Liverpool,2-0,2,0,1,1,2,2,H,"Welsh, Don",0,Away
1880,1952-12-26,1952.0,Liverpool,Burnley,1-1,1,1,1,1,2,0,D,"Welsh, Don",1,Anfield
1881,1953-01-03,1952.0,Stoke City,Liverpool,3-1,3,1,1,1,4,2,H,"Welsh, Don",1,Away
1882,1953-01-17,1952.0,Liverpool,Manchester City,0-1,0,1,1,1,1,-1,A,"Welsh, Don",0,Anfield
1883,1953-01-24,1952.0,Portsmouth,Liverpool,3-1,3,1,1,1,4,2,H,"Welsh, Don",1,Away
1884,1953-02-07,1952.0,Middlesbrough,Liverpool,2-3,2,3,1,1,5,-1,A,"Welsh, Don",3,Away
1885,1953-02-14,1952.0,Liverpool,West Bromwich Albion,3-0,3,0,1,1,3,3,H,"Welsh, Don",3,Anfield
1886,1953-02-21,1952.0,Newcastle United,Liverpool,1-2,1,2,1,1,3,-1,A,"Welsh, Don",2,Away
1887,1953-03-04,1952.0,Liverpool,Bolton Wanderers,0-0,0,0,1,1,0,0,D,"Welsh, Don",0,Anfield
1888,1953-03-07,1952.0,Aston Villa,Liverpool,4-0,4,0,1,1,4,4,H,"Welsh, Don",0,Away
1889,1953-03-14,1952.0,Liverpool,Sunderland,2-0,2,0,1,1,2,2,H,"Welsh, Don",2,Anfield
1890,1953-03-21,1952.0,Wolverhampton Wanderers,Liverpool,3-0,3,0,1,1,3,3,H,"Welsh, Don",0,Away
1891,1953-03-23,1952.0,Chelsea,Liverpool,3-0,3,0,1,1,3,3,H,"Welsh, Don",0,Away
1892,1953-03-28,1952.0,Liverpool,Charlton Athletic,1-2,1,2,1,1,3,-1,A,"Welsh, Don",1,Anfield
1893,1953-04-03,1952.0,Liverpool,Cardiff City,2-1,2,1,1,1,3,1,H,"Welsh, Don",2,Anfield
1894,1953-04-04,1952.0,Arsenal,Liverpool,5-3,5,3,1,1,8,2,H,"Welsh, Don",3,Away
1895,1953-04-06,1952.0,Cardiff City,Liverpool,4-0,4,0,1,1,4,4,H,"Welsh, Don",0,Away
1896,1953-04-11,1952.0,Liverpool,Derby County,1-1,1,1,1,1,2,0,D,"Welsh, Don",1,Anfield
1897,1953-04-18,1952.0,Blackpool,Liverpool,3-1,3,1,1,1,4,2,H,"Welsh, Don",1,Away
1898,1953-04-20,1952.0,Manchester United,Liverpool,3-1,3,1,1,1,4,2,H,"Welsh, Don",1,Away
1899,1953-04-25,1952.0,Liverpool,Chelsea,2-0,2,0,1,1,2,2,H,"Welsh, Don",2,Anfield
1900,1953-08-19,1953.0,Liverpool,Portsmouth,3-1,3,1,1,1,4,2,H,"Welsh, Don",3,Anfield
1901,1953-08-22,1953.0,Liverpool,Manchester United,4-4,4,4,1,1,8,0,D,"Welsh, Don",4,Anfield
1902,1953-08-26,1953.0,Liverpool,Newcastle United,2-2,2,2,1,1,4,0,D,"Welsh, Don",2,Anfield
1903,1953-08-29,1953.0,Bolton Wanderers,Liverpool,2-0,2,0,1,1,2,2,H,"Welsh, Don",0,Away
1904,1953-09-02,1953.0,Newcastle United,Liverpool,4-0,4,0,1,1,4,4,H,"Welsh, Don",0,Away
1905,1953-09-05,1953.0,Liverpool,Preston North End,1-5,1,5,1,1,6,-4,A,"Welsh, Don",1,Anfield
1906,1953-09-07,1953.0,Wolverhampton Wanderers,Liverpool,2-1,2,1,1,1,3,1,H,"Welsh, Don",1,Away
1907,1953-09-12,1953.0,Tottenham Hotspur,Liverpool,2-1,2,1,1,1,3,1,H,"Welsh, Don",1,Away
1908,1953-09-16,1953.0,Liverpool,Wolverhampton Wanderers,1-1,1,1,1,1,2,0,D,"Welsh, Don",1,Anfield
1909,1953-09-19,1953.0,Liverpool,Burnley,4-0,4,0,1,1,4,4,H,"Welsh, Don",4,Anfield
1910,1953-09-26,1953.0,Charlton Athletic,Liverpool,6-0,6,0,1,1,6,6,H,"Welsh, Don",0,Away
1911,1953-10-03,1953.0,Liverpool,Sheffield Wednesday,2-2,2,2,1,1,4,0,D,"Welsh, Don",2,Anfield
1912,1953-10-10,1953.0,Liverpool,Aston Villa,6-1,6,1,1,1,7,5,H,"Welsh, Don",6,Anfield
1913,1953-10-17,1953.0,Huddersfield Town,Liverpool,2-0,2,0,1,1,2,2,H,"Welsh, Don",0,Away
1914,1953-10-24,1953.0,Liverpool,Sheffield United,3-0,3,0,1,1,3,3,H,"Welsh, Don",3,Anfield
1915,1953-10-31,1953.0,Chelsea,Liverpool,5-2,5,2,1,1,7,3,H,"Welsh, Don",2,Away
1916,1953-11-07,1953.0,Liverpool,Manchester City,2-2,2,2,1,1,4,0,D,"Welsh, Don",2,Anfield
1917,1953-11-14,1953.0,Sunderland,Liverpool,3-2,3,2,1,1,5,1,H,"Welsh, Don",2,Away
1918,1953-11-21,1953.0,Liverpool,Arsenal,1-2,1,2,1,1,3,-1,A,"Welsh, Don",1,Anfield
1919,1953-11-28,1953.0,Cardiff City,Liverpool,3-1,3,1,1,1,4,2,H,"Welsh, Don",1,Away
1920,1953-12-05,1953.0,Liverpool,Blackpool,5-2,5,2,1,1,7,3,H,"Welsh, Don",5,Anfield
1921,1953-12-12,1953.0,Portsmouth,Liverpool,5-1,5,1,1,1,6,4,H,"Welsh, Don",1,Away
1922,1953-12-19,1953.0,Manchester United,Liverpool,5-1,5,1,1,1,6,4,H,"Welsh, Don",1,Away
1923,1953-12-25,1953.0,West Bromwich Albion,Liverpool,5-2,5,2,1,1,7,3,H,"Welsh, Don",2,Away
1924,1953-12-26,1953.0,Liverpool,West Bromwich Albion,0-0,0,0,1,1,0,0,D,"Welsh, Don",0,Anfield
1925,1954-01-02,1953.0,Liverpool,Bolton Wanderers,1-2,1,2,1,1,3,-1,A,"Welsh, Don",1,Anfield
1926,1954-01-16,1953.0,Preston North End,Liverpool,2-1,2,1,1,1,3,1,H,"Welsh, Don",1,Away
1927,1954-01-23,1953.0,Liverpool,Tottenham Hotspur,2-2,2,2,1,1,4,0,D,"Welsh, Don",2,Anfield
1928,1954-02-06,1953.0,Burnley,Liverpool,1-1,1,1,1,1,2,0,D,"Welsh, Don",1,Away
1929,1954-02-13,1953.0,Liverpool,Charlton Athletic,2-3,2,3,1,1,5,-1,A,"Welsh, Don",2,Anfield
1930,1954-02-24,1953.0,Sheffield Wednesday,Liverpool,1-1,1,1,1,1,2,0,D,"Welsh, Don",1,Away
1931,1954-02-27,1953.0,Aston Villa,Liverpool,2-1,2,1,1,1,3,1,H,"Welsh, Don",1,Away
1932,1954-03-06,1953.0,Liverpool,Huddersfield Town,1-3,1,3,1,1,4,-2,A,"Welsh, Don",1,Anfield
1933,1954-03-13,1953.0,Sheffield United,Liverpool,3-1,3,1,1,1,4,2,H,"Welsh, Don",1,Away
1934,1954-03-20,1953.0,Liverpool,Chelsea,1-1,1,1,1,1,2,0,D,"Welsh, Don",1,Anfield
1935,1954-04-03,1953.0,Liverpool,Sunderland,4-3,4,3,1,1,7,1,H,"Welsh, Don",4,Anfield
1936,1954-04-07,1953.0,Manchester City,Liverpool,0-2,0,2,1,1,2,-2,A,"Welsh, Don",2,Away
1937,1954-04-10,1953.0,Arsenal,Liverpool,3-0,3,0,1,1,3,3,H,"Welsh, Don",0,Away
1938,1954-04-16,1953.0,Middlesbrough,Liverpool,0-1,0,1,1,1,1,-1,A,"Welsh, Don",1,Away
1939,1954-04-17,1953.0,Liverpool,Cardiff City,0-1,0,1,1,1,1,-1,A,"Welsh, Don",0,Anfield
1940,1954-04-19,1953.0,Liverpool,Middlesbrough,4-1,4,1,1,1,5,3,H,"Welsh, Don",4,Anfield
1941,1954-04-24,1953.0,Blackpool,Liverpool,3-0,3,0,1,1,3,3,H,"Welsh, Don",0,Away
1942,1954-08-21,1954.0,Liverpool,Doncaster Rovers,3-2,3,2,2,2,5,1,H,"Welsh, Don",3,Anfield
1943,1954-08-23,1954.0,Plymouth Argyle,Liverpool,1-0,1,0,2,2,1,1,H,"Welsh, Don",0,Away
1944,1954-08-28,1954.0,Derby County,Liverpool,3-2,3,2,2,2,5,1,H,"Welsh, Don",2,Away
1945,1954-09-01,1954.0,Liverpool,Plymouth Argyle,3-3,3,3,2,2,6,0,D,"Welsh, Don",3,Anfield
1946,1954-09-04,1954.0,Liverpool,West Ham United,1-2,1,2,2,2,3,-1,A,"Welsh, Don",1,Anfield
1947,1954-09-06,1954.0,Bristol Rovers,Liverpool,3-0,3,0,2,2,3,3,H,"Welsh, Don",0,Away
1948,1954-09-11,1954.0,Blackburn Rovers,Liverpool,4-3,4,3,2,2,7,1,H,"Welsh, Don",3,Away
1949,1954-09-15,1954.0,Liverpool,Bristol Rovers,5-3,5,3,2,2,8,2,H,"Welsh, Don",5,Anfield
1950,1954-09-18,1954.0,Liverpool,Fulham,4-1,4,1,2,2,5,3,H,"Welsh, Don",4,Anfield
1951,1954-09-25,1954.0,Swansea City,Liverpool,3-2,3,2,2,2,5,1,H,"Welsh, Don",2,Away
1952,1954-10-02,1954.0,Liverpool,Notts County,3-1,3,1,2,2,4,2,H,"Welsh, Don",3,Anfield
1953,1954-10-09,1954.0,Liverpool,Rotherham United,3-1,3,1,2,2,4,2,H,"Welsh, Don",3,Anfield
1954,1954-10-16,1954.0,Stoke City,Liverpool,2-0,2,0,2,2,2,2,H,"Welsh, Don",0,Away
1955,1954-10-23,1954.0,Liverpool,Bury,1-1,1,1,2,2,2,0,D,"Welsh, Don",1,Anfield
1956,1954-10-30,1954.0,Lincoln City,Liverpool,3-3,3,3,2,2,6,0,D,"Welsh, Don",3,Away
1957,1954-11-06,1954.0,Liverpool,Hull City,2-1,2,1,2,2,3,1,H,"Welsh, Don",2,Anfield
1958,1954-11-13,1954.0,Luton Town,Liverpool,3-2,3,2,2,2,5,1,H,"Welsh, Don",2,Away
1959,1954-11-20,1954.0,Liverpool,Nottingham Forest,1-0,1,0,2,2,1,1,H,"Welsh, Don",1,Anfield
1960,1954-11-27,1954.0,Leeds United,Liverpool,2-2,2,2,2,2,4,0,D,"Welsh, Don",2,Away
1961,1954-12-04,1954.0,Liverpool,Middlesbrough,3-1,3,1,2,2,4,2,H,"Welsh, Don",3,Anfield
1962,1954-12-11,1954.0,Birmingham City,Liverpool,9-1,9,1,2,2,10,8,H,"Welsh, Don",1,Away
1963,1954-12-18,1954.0,Doncaster Rovers,Liverpool,4-1,4,1,2,2,5,3,H,"Welsh, Don",1,Away
1964,1954-12-25,1954.0,Liverpool,Ipswich Town,6-2,6,2,2,2,8,4,H,"Welsh, Don",6,Anfield
1965,1954-12-27,1954.0,Ipswich Town,Liverpool,2-0,2,0,2,2,2,2,H,"Welsh, Don",0,Away
1966,1955-01-01,1954.0,Liverpool,Derby County,2-0,2,0,2,2,2,2,H,"Welsh, Don",2,Anfield
1967,1955-01-22,1954.0,Liverpool,Blackburn Rovers,4-1,4,1,2,2,5,3,H,"Welsh, Don",4,Anfield
1968,1955-02-05,1954.0,Fulham,Liverpool,1-2,1,2,2,2,3,-1,A,"Welsh, Don",2,Away
1969,1955-02-12,1954.0,Liverpool,Swansea City,1-1,1,1,2,2,2,0,D,"Welsh, Don",1,Anfield
1970,1955-03-03,1954.0,Notts County,Liverpool,0-3,0,3,2,2,3,-3,A,"Welsh, Don",3,Away
1971,1955-03-05,1954.0,Liverpool,Stoke City,2-4,2,4,2,2,6,-2,A,"Welsh, Don",2,Anfield
1972,1955-03-12,1954.0,Bury,Liverpool,3-4,3,4,2,2,7,-1,A,"Welsh, Don",4,Away
1973,1955-03-19,1954.0,Liverpool,Lincoln City,2-4,2,4,2,2,6,-2,A,"Welsh, Don",2,Anfield
1974,1955-03-26,1954.0,Hull City,Liverpool,2-2,2,2,2,2,4,0,D,"Welsh, Don",2,Away
1975,1955-04-02,1954.0,Liverpool,Luton Town,4-4,4,4,2,2,8,0,D,"Welsh, Don",4,Anfield
1976,1955-04-08,1954.0,Port Vale,Liverpool,4-3,4,3,2,2,7,1,H,"Welsh, Don",3,Away
1977,1955-04-09,1954.0,Nottingham Forest,Liverpool,3-1,3,1,2,2,4,2,H,"Welsh, Don",1,Away
1978,1955-04-11,1954.0,Liverpool,Port Vale,1-1,1,1,2,2,2,0,D,"Welsh, Don",1,Anfield
1979,1955-04-16,1954.0,Liverpool,Leeds United,2-2,2,2,2,2,4,0,D,"Welsh, Don",2,Anfield
1980,1955-04-23,1954.0,Middlesbrough,Liverpool,1-2,1,2,2,2,3,-1,A,"Welsh, Don",2,Away
1981,1955-04-26,1954.0,West Ham United,Liverpool,0-3,0,3,2,2,3,-3,A,"Welsh, Don",3,Away
1982,1955-04-30,1954.0,Liverpool,Birmingham City,2-2,2,2,2,2,4,0,D,"Welsh, Don",2,Anfield
1983,1955-05-02,1954.0,Rotherham United,Liverpool,6-1,6,1,2,2,7,5,H,"Welsh, Don",1,Away
1984,1955-08-20,1955.0,Nottingham Forest,Liverpool,1-3,1,3,2,2,4,-2,A,"Welsh, Don",3,Away
1985,1955-08-24,1955.0,Liverpool,Sheffield Wednesday,0-3,0,3,2,2,3,-3,A,"Welsh, Don",0,Anfield
1986,1955-08-27,1955.0,Liverpool,Hull City,3-0,3,0,2,2,3,3,H,"Welsh, Don",3,Anfield
1987,1955-08-31,1955.0,Sheffield Wednesday,Liverpool,1-1,1,1,2,2,2,0,D,"Welsh, Don",1,Away
1988,1955-09-03,1955.0,Blackburn Rovers,Liverpool,3-3,3,3,2,2,6,0,D,"Welsh, Don",3,Away
1989,1955-09-07,1955.0,Liverpool,Bristol Rovers,0-2,0,2,2,2,2,-2,A,"Welsh, Don",0,Anfield
1990,1955-09-10,1955.0,Liverpool,Lincoln City,2-1,2,1,2,2,3,1,H,"Welsh, Don",2,Anfield
1991,1955-09-17,1955.0,Leicester City,Liverpool,3-1,3,1,2,2,4,2,H,"Welsh, Don",1,Away
1992,1955-09-24,1955.0,Liverpool,Middlesbrough,1-1,1,1,2,2,2,0,D,"Welsh, Don",1,Anfield
1993,1955-10-01,1955.0,Liverpool,Plymouth Argyle,4-1,4,1,2,2,5,3,H,"Welsh, Don",4,Anfield
1994,1955-10-08,1955.0,Bristol City,Liverpool,2-1,2,1,2,2,3,1,H,"Welsh, Don",1,Away
1995,1955-10-15,1955.0,Liverpool,West Ham United,3-1,3,1,2,2,4,2,H,"Welsh, Don",3,Anfield
1996,1955-10-22,1955.0,Bury,Liverpool,1-4,1,4,2,2,5,-3,A,"Welsh, Don",4,Away
1997,1955-10-29,1955.0,Liverpool,Rotherham United,2-0,2,0,2,2,2,2,H,"Welsh, Don",2,Anfield
1998,1955-11-05,1955.0,Swansea City,Liverpool,2-1,2,1,2,2,3,1,H,"Welsh, Don",1,Away
1999,1955-11-12,1955.0,Liverpool,Notts County,2-1,2,1,2,2,3,1,H,"Welsh, Don",2,Anfield
2000,1955-11-19,1955.0,Leeds United,Liverpool,4-2,4,2,2,2,6,2,H,"Welsh, Don",2,Away
2001,1955-11-26,1955.0,Liverpool,Fulham,7-0,7,0,2,2,7,7,H,"Welsh, Don",7,Anfield
2002,1955-12-03,1955.0,Port Vale,Liverpool,1-1,1,1,2,2,2,0,D,"Welsh, Don",1,Away
2003,1955-12-10,1955.0,Liverpool,Barnsley,1-1,1,1,2,2,2,0,D,"Welsh, Don",1,Anfield
2004,1955-12-17,1955.0,Liverpool,Nottingham Forest,5-2,5,2,2,2,7,3,H,"Welsh, Don",5,Anfield
2005,1955-12-24,1955.0,Hull City,Liverpool,1-2,1,2,2,2,3,-1,A,"Welsh, Don",2,Away
2006,1955-12-26,1955.0,Liverpool,Stoke City,2-2,2,2,2,2,4,0,D,"Welsh, Don",2,Anfield
2007,1955-12-27,1955.0,Stoke City,Liverpool,3-2,3,2,2,2,5,1,H,"Welsh, Don",2,Away
2008,1955-12-31,1955.0,Liverpool,Blackburn Rovers,1-2,1,2,2,2,3,-1,A,"Welsh, Don",1,Anfield
2009,1956-01-21,1955.0,Liverpool,Leicester City,3-1,3,1,2,2,4,2,H,"Welsh, Don",3,Anfield
2010,1956-02-04,1955.0,Middlesbrough,Liverpool,1-2,1,2,2,2,3,-1,A,"Welsh, Don",2,Away
2011,1956-02-11,1955.0,Plymouth Argyle,Liverpool,4-0,4,0,2,2,4,4,H,"Welsh, Don",0,Away
2012,1956-02-25,1955.0,West Ham United,Liverpool,2-0,2,0,2,2,2,2,H,"Welsh, Don",0,Away
2013,1956-02-29,1955.0,Liverpool,Leeds United,1-0,1,0,2,2,1,1,H,"Welsh, Don",1,Anfield
2014,1956-03-03,1955.0,Liverpool,Bury,4-2,4,2,2,2,6,2,H,"Welsh, Don",4,Anfield
2015,1956-03-10,1955.0,Barnsley,Liverpool,0-5,0,5,2,2,5,-5,A,"Welsh, Don",5,Away
2016,1956-03-17,1955.0,Liverpool,Swansea City,4-1,4,1,2,2,5,3,H,"Welsh, Don",4,Anfield
2017,1956-03-24,1955.0,Notts County,Liverpool,2-1,2,1,2,2,3,1,H,"Welsh, Don",1,Away
2018,1956-03-30,1955.0,Doncaster Rovers,Liverpool,1-0,1,0,2,2,1,1,H,"Welsh, Don",0,Away
2019,1956-03-31,1955.0,Liverpool,Bristol City,2-1,2,1,2,2,3,1,H,"Welsh, Don",2,Anfield
2020,1956-04-02,1955.0,Liverpool,Doncaster Rovers,1-2,1,2,2,2,3,-1,A,"Welsh, Don",1,Anfield
2021,1956-04-07,1955.0,Fulham,Liverpool,3-1,3,1,2,2,4,2,H,"Welsh, Don",1,Away
2022,1956-04-14,1955.0,Liverpool,Port Vale,4-1,4,1,2,2,5,3,H,"Welsh, Don",4,Anfield
2023,1956-04-21,1955.0,Rotherham United,Liverpool,0-1,0,1,2,2,1,-1,A,"Welsh, Don",1,Away
2024,1956-04-28,1955.0,Bristol Rovers,Liverpool,1-2,1,2,2,2,3,-1,A,"Welsh, Don",2,Away
2025,1956-05-02,1955.0,Lincoln City,Liverpool,2-0,2,0,2,2,2,2,H,"Welsh, Don",0,Away
2026,1956-08-18,1956.0,Liverpool,Huddersfield Town,2-3,2,3,2,2,5,-1,A,"Taylor, Phil",2,Anfield
2027,1956-08-23,1956.0,Notts County,Liverpool,1-1,1,1,2,2,2,0,D,"Taylor, Phil",1,Away
2028,1956-08-25,1956.0,Bury,Liverpool,0-2,0,2,2,2,2,-2,A,"Taylor, Phil",2,Away
2029,1956-08-29,1956.0,Liverpool,Notts County,3-3,3,3,2,2,6,0,D,"Taylor, Phil",3,Anfield
2030,1956-09-01,1956.0,Liverpool,Grimsby Town,3-2,3,2,2,2,5,1,H,"Taylor, Phil",3,Anfield
2031,1956-09-03,1956.0,West Ham United,Liverpool,1-1,1,1,2,2,2,0,D,"Taylor, Phil",1,Away
2032,1956-09-08,1956.0,Doncaster Rovers,Liverpool,1-1,1,1,2,2,2,0,D,"Taylor, Phil",1,Away
2033,1956-09-15,1956.0,Liverpool,Stoke City,0-2,0,2,2,2,2,-2,A,"Taylor, Phil",0,Anfield
2034,1956-09-22,1956.0,Middlesbrough,Liverpool,1-1,1,1,2,2,2,0,D,"Taylor, Phil",1,Away
2035,1956-09-29,1956.0,Liverpool,Leicester City,2-0,2,0,2,2,2,2,H,"Taylor, Phil",2,Anfield
2036,1956-10-06,1956.0,Liverpool,Blackburn Rovers,2-3,2,3,2,2,5,-1,A,"Taylor, Phil",2,Anfield
2037,1956-10-13,1956.0,Bristol City,Liverpool,2-1,2,1,2,2,3,1,H,"Taylor, Phil",1,Away
2038,1956-10-20,1956.0,Liverpool,Fulham,4-3,4,3,2,2,7,1,H,"Taylor, Phil",4,Anfield
2039,1956-10-27,1956.0,Barnsley,Liverpool,4-1,4,1,2,2,5,3,H,"Taylor, Phil",1,Away
2040,1956-11-03,1956.0,Liverpool,Port Vale,4-1,4,1,2,2,5,3,H,"Taylor, Phil",4,Anfield
2041,1956-11-10,1956.0,Rotherham United,Liverpool,2-2,2,2,2,2,4,0,D,"Taylor, Phil",2,Away
2042,1956-11-17,1956.0,Liverpool,Lincoln City,4-0,4,0,2,2,4,4,H,"Taylor, Phil",4,Anfield
2043,1956-11-24,1956.0,Swansea City,Liverpool,1-1,1,1,2,2,2,0,D,"Taylor, Phil",1,Away
2044,1956-12-01,1956.0,Liverpool,Sheffield United,5-1,5,1,2,2,6,4,H,"Taylor, Phil",5,Anfield
2045,1956-12-08,1956.0,Nottingham Forest,Liverpool,1-0,1,0,2,2,1,1,H,"Taylor, Phil",0,Away
2046,1956-12-15,1956.0,Huddersfield Town,Liverpool,0-3,0,3,2,2,3,-3,A,"Taylor, Phil",3,Away
2047,1956-12-22,1956.0,Liverpool,Bury,2-0,2,0,2,2,2,2,H,"Taylor, Phil",2,Anfield
2048,1956-12-25,1956.0,Liverpool,Leyton Orient,1-0,1,0,2,2,1,1,H,"Taylor, Phil",1,Anfield
2049,1956-12-26,1956.0,Leyton Orient,Liverpool,0-4,0,4,2,2,4,-4,A,"Taylor, Phil",4,Away
2050,1956-12-29,1956.0,Grimsby Town,Liverpool,0-0,0,0,2,2,0,0,D,"Taylor, Phil",0,Away
2051,1957-01-12,1956.0,Liverpool,Doncaster Rovers,2-1,2,1,2,2,3,1,H,"Taylor, Phil",2,Anfield
2052,1957-01-19,1956.0,Stoke City,Liverpool,1-0,1,0,2,2,1,1,H,"Taylor, Phil",0,Away
2053,1957-02-02,1956.0,Liverpool,Middlesbrough,1-2,1,2,2,2,3,-1,A,"Taylor, Phil",1,Anfield
2054,1957-02-09,1956.0,Leicester City,Liverpool,3-2,3,2,2,2,5,1,H,"Taylor, Phil",2,Away
2055,1957-02-16,1956.0,Blackburn Rovers,Liverpool,2-2,2,2,2,2,4,0,D,"Taylor, Phil",2,Away
2056,1957-03-02,1956.0,Fulham,Liverpool,1-2,1,2,2,2,3,-1,A,"Taylor, Phil",2,Away
2057,1957-03-09,1956.0,Liverpool,Barnsley,2-1,2,1,2,2,3,1,H,"Taylor, Phil",2,Anfield
2058,1957-03-16,1956.0,Port Vale,Liverpool,1-2,1,2,2,2,3,-1,A,"Taylor, Phil",2,Away
2059,1957-03-23,1956.0,Liverpool,Rotherham United,4-1,4,1,2,2,5,3,H,"Taylor, Phil",4,Anfield
2060,1957-03-30,1956.0,Lincoln City,Liverpool,3-3,3,3,2,2,6,0,D,"Taylor, Phil",3,Away
2061,1957-04-06,1956.0,Liverpool,Swansea City,2-0,2,0,2,2,2,2,H,"Taylor, Phil",2,Anfield
2062,1957-04-13,1956.0,Sheffield United,Liverpool,3-0,3,0,2,2,3,3,H,"Taylor, Phil",0,Away
2063,1957-04-19,1956.0,Liverpool,Bristol Rovers,4-1,4,1,2,2,5,3,H,"Taylor, Phil",4,Anfield
2064,1957-04-20,1956.0,Liverpool,Nottingham Forest,3-1,3,1,2,2,4,2,H,"Taylor, Phil",3,Anfield
2065,1957-04-22,1956.0,Bristol Rovers,Liverpool,0-0,0,0,2,2,0,0,D,"Taylor, Phil",0,Away
2066,1957-04-27,1956.0,Liverpool,West Ham United,1-0,1,0,2,2,1,1,H,"Taylor, Phil",1,Anfield
2067,1957-05-01,1956.0,Liverpool,Bristol City,2-1,2,1,2,2,3,1,H,"Taylor, Phil",2,Anfield
2068,1957-08-24,1957.0,Bristol City,Liverpool,1-2,1,2,2,2,3,-1,A,"Taylor, Phil",2,Away
2069,1957-08-28,1957.0,Liverpool,Huddersfield Town,1-1,1,1,2,2,2,0,D,"Taylor, Phil",1,Anfield
2070,1957-08-31,1957.0,Liverpool,Cardiff City,3-0,3,0,2,2,3,3,H,"Taylor, Phil",3,Anfield
2071,1957-09-04,1957.0,Huddersfield Town,Liverpool,2-1,2,1,2,2,3,1,H,"Taylor, Phil",1,Away
2072,1957-09-07,1957.0,Fulham,Liverpool,2-2,2,2,2,2,4,0,D,"Taylor, Phil",2,Away
2073,1957-09-14,1957.0,Middlesbrough,Liverpool,2-2,2,2,2,2,4,0,D,"Taylor, Phil",2,Away
2074,1957-09-19,1957.0,Rotherham United,Liverpool,2-2,2,2,2,2,4,0,D,"Taylor, Phil",2,Away
2075,1957-09-21,1957.0,Liverpool,Leyton Orient,3-0,3,0,2,2,3,3,H,"Taylor, Phil",3,Anfield
2076,1957-09-23,1957.0,Stoke City,Liverpool,1-2,1,2,2,2,3,-1,A,"Taylor, Phil",2,Away
2077,1957-09-28,1957.0,Charlton Athletic,Liverpool,5-1,5,1,2,2,6,4,H,"Taylor, Phil",1,Away
2078,1957-10-05,1957.0,Liverpool,Doncaster Rovers,5-0,5,0,2,2,5,5,H,"Taylor, Phil",5,Anfield
2079,1957-10-12,1957.0,Liverpool,Swansea City,4-0,4,0,2,2,4,4,H,"Taylor, Phil",4,Anfield
2080,1957-10-19,1957.0,Derby County,Liverpool,2-1,2,1,2,2,3,1,H,"Taylor, Phil",1,Away
2081,1957-10-26,1957.0,Liverpool,Bristol Rovers,2-0,2,0,2,2,2,2,H,"Taylor, Phil",2,Anfield
2082,1957-11-02,1957.0,Lincoln City,Liverpool,0-1,0,1,2,2,1,-1,A,"Taylor, Phil",1,Away
2083,1957-11-09,1957.0,Liverpool,Notts County,4-0,4,0,2,2,4,4,H,"Taylor, Phil",4,Anfield
2084,1957-11-16,1957.0,Ipswich Town,Liverpool,3-1,3,1,2,2,4,2,H,"Taylor, Phil",1,Away
2085,1957-11-23,1957.0,Liverpool,Blackburn Rovers,2-0,2,0,2,2,2,2,H,"Taylor, Phil",2,Anfield
2086,1957-11-27,1957.0,Liverpool,Rotherham United,2-0,2,0,2,2,2,2,H,"Taylor, Phil",2,Anfield
2087,1957-11-30,1957.0,Sheffield United,Liverpool,1-1,1,1,2,2,2,0,D,"Taylor, Phil",1,Away
2088,1957-12-07,1957.0,Liverpool,West Ham United,1-1,1,1,2,2,2,0,D,"Taylor, Phil",1,Anfield
2089,1957-12-14,1957.0,Barnsley,Liverpool,2-1,2,1,2,2,3,1,H,"Taylor, Phil",1,Away
2090,1957-12-21,1957.0,Liverpool,Bristol City,4-3,4,3,2,2,7,1,H,"Taylor, Phil",4,Anfield
2091,1957-12-25,1957.0,Grimsby Town,Liverpool,3-1,3,1,2,2,4,2,H,"Taylor, Phil",1,Away
2092,1957-12-26,1957.0,Liverpool,Grimsby Town,3-2,3,2,2,2,5,1,H,"Taylor, Phil",3,Anfield
2093,1957-12-28,1957.0,Cardiff City,Liverpool,6-1,6,1,2,2,7,5,H,"Taylor, Phil",1,Away
2094,1958-01-11,1957.0,Liverpool,Fulham,2-1,2,1,2,2,3,1,H,"Taylor, Phil",2,Anfield
2095,1958-01-18,1957.0,Liverpool,Middlesbrough,0-2,0,2,2,2,2,-2,A,"Taylor, Phil",0,Anfield
2096,1958-02-01,1957.0,Leyton Orient,Liverpool,1-0,1,0,2,2,1,1,H,"Taylor, Phil",0,Away
2097,1958-02-08,1957.0,Liverpool,Charlton Athletic,3-1,3,1,2,2,4,2,H,"Taylor, Phil",3,Anfield
2098,1958-02-19,1957.0,Doncaster Rovers,Liverpool,1-1,1,1,2,2,2,0,D,"Taylor, Phil",1,Away
2099,1958-02-22,1957.0,Blackburn Rovers,Liverpool,3-3,3,3,2,2,6,0,D,"Taylor, Phil",3,Away
2100,1958-03-05,1957.0,Liverpool,Derby County,2-0,2,0,2,2,2,2,H,"Taylor, Phil",2,Anfield
2101,1958-03-08,1957.0,Bristol Rovers,Liverpool,3-1,3,1,2,2,4,2,H,"Taylor, Phil",1,Away
2102,1958-03-15,1957.0,Liverpool,Lincoln City,1-0,1,0,2,2,1,1,H,"Taylor, Phil",1,Anfield
2103,1958-03-22,1957.0,Notts County,Liverpool,0-2,0,2,2,2,2,-2,A,"Taylor, Phil",2,Away
2104,1958-03-29,1957.0,Liverpool,Ipswich Town,3-1,3,1,2,2,4,2,H,"Taylor, Phil",3,Anfield
2105,1958-04-05,1957.0,Swansea City,Liverpool,0-2,0,2,2,2,2,-2,A,"Taylor, Phil",2,Away
2106,1958-04-07,1957.0,Liverpool,Stoke City,3-0,3,0,2,2,3,3,H,"Taylor, Phil",3,Anfield
2107,1958-04-12,1957.0,Liverpool,Sheffield United,1-0,1,0,2,2,1,1,H,"Taylor, Phil",1,Anfield
2108,1958-04-19,1957.0,West Ham United,Liverpool,1-1,1,1,2,2,2,0,D,"Taylor, Phil",1,Away
2109,1958-04-26,1957.0,Liverpool,Barnsley,1-1,1,1,2,2,2,0,D,"Taylor, Phil",1,Anfield
2110,1958-08-23,1958.0,Liverpool,Grimsby Town,3-3,3,3,2,2,6,0,D,"Taylor, Phil",3,Anfield
2111,1958-08-30,1958.0,Sunderland,Liverpool,2-1,2,1,2,2,3,1,H,"Taylor, Phil",1,Away
2112,1958-09-03,1958.0,Liverpool,Brighton & Hove Albion,5-0,5,0,2,2,5,5,H,"Taylor, Phil",5,Anfield
2113,1958-09-06,1958.0,Middlesbrough,Liverpool,2-1,2,1,2,2,3,1,H,"Taylor, Phil",1,Away
2114,1958-09-10,1958.0,Liverpool,Sheffield United,2-1,2,1,2,2,3,1,H,"Taylor, Phil",2,Anfield
2115,1958-09-13,1958.0,Liverpool,Charlton Athletic,3-0,3,0,2,2,3,3,H,"Taylor, Phil",3,Anfield
2116,1958-09-15,1958.0,Sheffield United,Liverpool,2-0,2,0,2,2,2,2,H,"Taylor, Phil",0,Away
2117,1958-09-20,1958.0,Bristol City,Liverpool,1-3,1,3,2,2,4,-2,A,"Taylor, Phil",3,Away
2118,1958-09-24,1958.0,Brighton & Hove Albion,Liverpool,2-2,2,2,2,2,4,0,D,"Taylor, Phil",2,Away
2119,1958-09-27,1958.0,Liverpool,Cardiff City,1-2,1,2,2,2,3,-1,A,"Taylor, Phil",1,Anfield
2120,1958-10-04,1958.0,Huddersfield Town,Liverpool,5-0,5,0,2,2,5,5,H,"Taylor, Phil",0,Away
2121,1958-10-11,1958.0,Liverpool,Lincoln City,3-2,3,2,2,2,5,1,H,"Taylor, Phil",3,Anfield
2122,1958-10-18,1958.0,Fulham,Liverpool,0-1,0,1,2,2,1,-1,A,"Taylor, Phil",1,Away
2123,1958-10-25,1958.0,Liverpool,Sheffield Wednesday,3-2,3,2,2,2,5,1,H,"Taylor, Phil",3,Anfield
2124,1958-11-01,1958.0,Stoke City,Liverpool,0-2,0,2,2,2,2,-2,A,"Taylor, Phil",2,Away
2125,1958-11-08,1958.0,Liverpool,Leyton Orient,3-0,3,0,2,2,3,3,H,"Taylor, Phil",3,Anfield
2126,1958-11-15,1958.0,Derby County,Liverpool,3-2,3,2,2,2,5,1,H,"Taylor, Phil",2,Away
2127,1958-11-22,1958.0,Liverpool,Bristol Rovers,2-1,2,1,2,2,3,1,H,"Taylor, Phil",2,Anfield
2128,1958-11-29,1958.0,Ipswich Town,Liverpool,2-0,2,0,2,2,2,2,H,"Taylor, Phil",0,Away
2129,1958-12-06,1958.0,Liverpool,Swansea City,4-0,4,0,2,2,4,4,H,"Taylor, Phil",4,Anfield
2130,1958-12-13,1958.0,Scunthorpe United,Liverpool,1-2,1,2,2,2,3,-1,A,"Taylor, Phil",2,Away
2131,1958-12-20,1958.0,Grimsby Town,Liverpool,2-3,2,3,2,2,5,-1,A,"Taylor, Phil",3,Away
2132,1958-12-26,1958.0,Rotherham United,Liverpool,0-1,0,1,2,2,1,-1,A,"Taylor, Phil",1,Away
2133,1958-12-27,1958.0,Liverpool,Rotherham United,4-0,4,0,2,2,4,4,H,"Taylor, Phil",4,Anfield
2134,1959-01-03,1958.0,Liverpool,Sunderland,3-1,3,1,2,2,4,2,H,"Taylor, Phil",3,Anfield
2135,1959-01-31,1958.0,Charlton Athletic,Liverpool,2-3,2,3,2,2,5,-1,A,"Taylor, Phil",3,Away
2136,1959-02-07,1958.0,Liverpool,Bristol City,3-2,3,2,2,2,5,1,H,"Taylor, Phil",3,Anfield
2137,1959-02-14,1958.0,Cardiff City,Liverpool,3-0,3,0,2,2,3,3,H,"Taylor, Phil",0,Away
2138,1959-02-21,1958.0,Liverpool,Huddersfield Town,2-2,2,2,2,2,4,0,D,"Taylor, Phil",2,Anfield
2139,1959-02-28,1958.0,Leyton Orient,Liverpool,1-3,1,3,2,2,4,-2,A,"Taylor, Phil",3,Away
2140,1959-03-07,1958.0,Liverpool,Fulham,0-0,0,0,2,2,0,0,D,"Taylor, Phil",0,Anfield
2141,1959-03-20,1958.0,Liverpool,Stoke City,3-4,3,4,2,2,7,-1,A,"Taylor, Phil",3,Anfield
2142,1959-03-27,1958.0,Liverpool,Barnsley,3-2,3,2,2,2,5,1,H,"Taylor, Phil",3,Anfield
2143,1959-03-28,1958.0,Lincoln City,Liverpool,2-1,2,1,2,2,3,1,H,"Taylor, Phil",1,Away
2144,1959-03-30,1958.0,Barnsley,Liverpool,0-2,0,2,2,2,2,-2,A,"Taylor, Phil",2,Away
2145,1959-04-04,1958.0,Liverpool,Derby County,3-0,3,0,2,2,3,3,H,"Taylor, Phil",3,Anfield
2146,1959-04-08,1958.0,Liverpool,Middlesbrough,1-2,1,2,2,2,3,-1,A,"Taylor, Phil",1,Anfield
2147,1959-04-11,1958.0,Bristol Rovers,Liverpool,3-0,3,0,2,2,3,3,H,"Taylor, Phil",0,Away
2148,1959-04-14,1958.0,Sheffield Wednesday,Liverpool,1-0,1,0,2,2,1,1,H,"Taylor, Phil",0,Away
2149,1959-04-18,1958.0,Liverpool,Ipswich Town,3-1,3,1,2,2,4,2,H,"Taylor, Phil",3,Anfield
2150,1959-04-22,1958.0,Liverpool,Scunthorpe United,3-0,3,0,2,2,3,3,H,"Taylor, Phil",3,Anfield
2151,1959-04-25,1958.0,Swansea City,Liverpool,3-3,3,3,2,2,6,0,D,"Taylor, Phil",3,Away
2152,1959-08-22,1959.0,Cardiff City,Liverpool,3-2,3,2,2,2,5,1,H,"Taylor, Phil",2,Away
2153,1959-08-26,1959.0,Liverpool,Bristol City,4-2,4,2,2,2,6,2,H,"Taylor, Phil",4,Anfield
2154,1959-08-29,1959.0,Liverpool,Hull City,5-3,5,3,2,2,8,2,H,"Taylor, Phil",5,Anfield
2155,1959-09-01,1959.0,Bristol City,Liverpool,1-0,1,0,2,2,1,1,H,"Taylor, Phil",0,Away
2156,1959-09-05,1959.0,Sheffield United,Liverpool,2-1,2,1,2,2,3,1,H,"Taylor, Phil",1,Away
2157,1959-09-09,1959.0,Liverpool,Scunthorpe United,2-0,2,0,2,2,2,2,H,"Taylor, Phil",2,Anfield
2158,1959-09-12,1959.0,Liverpool,Middlesbrough,1-2,1,2,2,2,3,-1,A,"Taylor, Phil",1,Anfield
2159,1959-09-17,1959.0,Scunthorpe United,Liverpool,1-1,1,1,2,2,2,0,D,"Taylor, Phil",1,Away
2160,1959-09-19,1959.0,Derby County,Liverpool,1-2,1,2,2,2,3,-1,A,"Taylor, Phil",2,Away
2161,1959-09-26,1959.0,Liverpool,Plymouth Argyle,4-1,4,1,2,2,5,3,H,"Taylor, Phil",4,Anfield
2162,1959-10-03,1959.0,Swansea City,Liverpool,5-4,5,4,2,2,9,1,H,"Taylor, Phil",4,Away
2163,1959-10-10,1959.0,Liverpool,Brighton & Hove Albion,2-2,2,2,2,2,4,0,D,"Taylor, Phil",2,Anfield
2164,1959-10-17,1959.0,Stoke City,Liverpool,1-1,1,1,2,2,2,0,D,"Taylor, Phil",1,Away
2165,1959-10-24,1959.0,Liverpool,Portsmouth,1-1,1,1,2,2,2,0,D,"Taylor, Phil",1,Anfield
2166,1959-10-31,1959.0,Sunderland,Liverpool,1-1,1,1,2,2,2,0,D,"Taylor, Phil",1,Away
2167,1959-11-07,1959.0,Liverpool,Aston Villa,2-1,2,1,2,2,3,1,H,"Taylor, Phil",2,Anfield
2168,1959-11-14,1959.0,Lincoln City,Liverpool,4-2,4,2,2,2,6,2,H,"Taylor, Phil",2,Away
2169,1959-11-21,1959.0,Liverpool,Leyton Orient,4-3,4,3,2,2,7,1,H,character(0),4,Anfield
2170,1959-11-28,1959.0,Huddersfield Town,Liverpool,1-0,1,0,2,2,1,1,H,character(0),0,Away
2171,1959-12-05,1959.0,Liverpool,Ipswich Town,3-1,3,1,2,2,4,2,H,"Shankly, Bill",3,Anfield
2172,1959-12-12,1959.0,Bristol Rovers,Liverpool,0-2,0,2,2,2,2,-2,A,"Shankly, Bill",2,Away
2173,1959-12-19,1959.0,Liverpool,Cardiff City,0-4,0,4,2,2,4,-4,A,"Shankly, Bill",0,Anfield
2174,1959-12-26,1959.0,Charlton Athletic,Liverpool,3-0,3,0,2,2,3,3,H,"Shankly, Bill",0,Away
2175,1959-12-28,1959.0,Liverpool,Charlton Athletic,2-0,2,0,2,2,2,2,H,"Shankly, Bill",2,Anfield
2176,1960-01-02,1959.0,Hull City,Liverpool,0-1,0,1,2,2,1,-1,A,"Shankly, Bill",1,Away
2177,1960-01-16,1959.0,Liverpool,Sheffield United,3-0,3,0,2,2,3,3,H,"Shankly, Bill",3,Anfield
2178,1960-01-23,1959.0,Middlesbrough,Liverpool,3-3,3,3,2,2,6,0,D,"Shankly, Bill",3,Away
2179,1960-02-13,1959.0,Plymouth Argyle,Liverpool,1-1,1,1,2,2,2,0,D,"Shankly, Bill",1,Away
2180,1960-02-20,1959.0,Liverpool,Swansea City,4-1,4,1,2,2,5,3,H,"Shankly, Bill",4,Anfield
2181,1960-02-27,1959.0,Brighton & Hove Albion,Liverpool,1-2,1,2,2,2,3,-1,A,"Shankly, Bill",2,Away
2182,1960-03-05,1959.0,Liverpool,Stoke City,5-1,5,1,2,2,6,4,H,"Shankly, Bill",5,Anfield
2183,1960-03-12,1959.0,Portsmouth,Liverpool,2-1,2,1,2,2,3,1,H,"Shankly, Bill",1,Away
2184,1960-03-19,1959.0,Liverpool,Huddersfield Town,2-2,2,2,2,2,4,0,D,"Shankly, Bill",2,Anfield
2185,1960-03-30,1959.0,Aston Villa,Liverpool,4-4,4,4,2,2,8,0,D,"Shankly, Bill",4,Away
2186,1960-04-02,1959.0,Liverpool,Lincoln City,1-3,1,3,2,2,4,-2,A,"Shankly, Bill",1,Anfield
2187,1960-04-06,1959.0,Liverpool,Derby County,4-1,4,1,2,2,5,3,H,"Shankly, Bill",4,Anfield
2188,1960-04-09,1959.0,Leyton Orient,Liverpool,2-0,2,0,2,2,2,2,H,"Shankly, Bill",0,Away
2189,1960-04-16,1959.0,Liverpool,Bristol Rovers,4-0,4,0,2,2,4,4,H,"Shankly, Bill",4,Anfield
2190,1960-04-18,1959.0,Liverpool,Rotherham United,3-0,3,0,2,2,3,3,H,"Shankly, Bill",3,Anfield
2191,1960-04-19,1959.0,Rotherham United,Liverpool,2-2,2,2,2,2,4,0,D,"Shankly, Bill",2,Away
2192,1960-04-23,1959.0,Ipswich Town,Liverpool,0-1,0,1,2,2,1,-1,A,"Shankly, Bill",1,Away
2193,1960-04-30,1959.0,Liverpool,Sunderland,3-0,3,0,2,2,3,3,H,"Shankly, Bill",3,Anfield
2194,1960-08-20,1960.0,Liverpool,Leeds United,2-0,2,0,2,2,2,2,H,"Shankly, Bill",2,Anfield
2195,1960-08-24,1960.0,Southampton,Liverpool,4-1,4,1,2,2,5,3,H,"Shankly, Bill",1,Away
2196,1960-08-27,1960.0,Middlesbrough,Liverpool,1-1,1,1,2,2,2,0,D,"Shankly, Bill",1,Away
2197,1960-08-31,1960.0,Liverpool,Southampton,0-1,0,1,2,2,1,-1,A,"Shankly, Bill",0,Anfield
2198,1960-09-03,1960.0,Liverpool,Brighton & Hove Albion,2-0,2,0,2,2,2,2,H,"Shankly, Bill",2,Anfield
2199,1960-09-07,1960.0,Liverpool,Luton Town,2-2,2,2,2,2,4,0,D,"Shankly, Bill",2,Anfield
2200,1960-09-10,1960.0,Ipswich Town,Liverpool,1-0,1,0,2,2,1,1,H,"Shankly, Bill",0,Away
2201,1960-09-14,1960.0,Luton Town,Liverpool,2-1,2,1,2,2,3,1,H,"Shankly, Bill",1,Away
2202,1960-09-17,1960.0,Liverpool,Scunthorpe United,3-2,3,2,2,2,5,1,H,"Shankly, Bill",3,Anfield
2203,1960-09-24,1960.0,Leyton Orient,Liverpool,1-3,1,3,2,2,4,-2,A,"Shankly, Bill",3,Away
2204,1960-10-01,1960.0,Liverpool,Derby County,1-0,1,0,2,2,1,1,H,"Shankly, Bill",1,Anfield
2205,1960-10-08,1960.0,Lincoln City,Liverpool,1-2,1,2,2,2,3,-1,A,"Shankly, Bill",2,Away
2206,1960-10-15,1960.0,Liverpool,Portsmouth,3-3,3,3,2,2,6,0,D,"Shankly, Bill",3,Anfield
2207,1960-10-22,1960.0,Huddersfield Town,Liverpool,2-4,2,4,2,2,6,-2,A,"Shankly, Bill",4,Away
2208,1960-10-29,1960.0,Liverpool,Sunderland,1-1,1,1,2,2,2,0,D,"Shankly, Bill",1,Anfield
2209,1960-11-05,1960.0,Plymouth Argyle,Liverpool,0-4,0,4,2,2,4,-4,A,"Shankly, Bill",4,Away
2210,1960-11-12,1960.0,Liverpool,Norwich City,2-1,2,1,2,2,3,1,H,"Shankly, Bill",2,Anfield
2211,1960-11-19,1960.0,Charlton Athletic,Liverpool,1-3,1,3,2,2,4,-2,A,"Shankly, Bill",3,Away
2212,1960-11-26,1960.0,Liverpool,Sheffield United,4-2,4,2,2,2,6,2,H,"Shankly, Bill",4,Anfield
2213,1960-12-10,1960.0,Liverpool,Swansea City,4-0,4,0,2,2,4,4,H,"Shankly, Bill",4,Anfield
2214,1960-12-17,1960.0,Leeds United,Liverpool,2-2,2,2,2,2,4,0,D,"Shankly, Bill",2,Away
2215,1960-12-26,1960.0,Liverpool,Rotherham United,2-1,2,1,2,2,3,1,H,"Shankly, Bill",2,Anfield
2216,1960-12-27,1960.0,Rotherham United,Liverpool,1-0,1,0,2,2,1,1,H,"Shankly, Bill",0,Away
2217,1960-12-31,1960.0,Liverpool,Middlesbrough,3-4,3,4,2,2,7,-1,A,"Shankly, Bill",3,Anfield
2218,1961-01-14,1960.0,Brighton & Hove Albion,Liverpool,3-1,3,1,2,2,4,2,H,"Shankly, Bill",1,Away
2219,1961-01-21,1960.0,Liverpool,Ipswich Town,1-1,1,1,2,2,2,0,D,"Shankly, Bill",1,Anfield
2220,1961-02-04,1960.0,Scunthorpe United,Liverpool,2-3,2,3,2,2,5,-1,A,"Shankly, Bill",3,Away
2221,1961-02-11,1960.0,Liverpool,Leyton Orient,5-0,5,0,2,2,5,5,H,"Shankly, Bill",5,Anfield
2222,1961-02-18,1960.0,Derby County,Liverpool,1-4,1,4,2,2,5,-3,A,"Shankly, Bill",4,Away
2223,1961-02-25,1960.0,Liverpool,Lincoln City,2-0,2,0,2,2,2,2,H,"Shankly, Bill",2,Anfield
2224,1961-03-04,1960.0,Portsmouth,Liverpool,2-2,2,2,2,2,4,0,D,"Shankly, Bill",2,Away
2225,1961-03-11,1960.0,Liverpool,Huddersfield Town,3-1,3,1,2,2,4,2,H,"Shankly, Bill",3,Anfield
2226,1961-03-18,1960.0,Swansea City,Liverpool,2-0,2,0,2,2,2,2,H,"Shankly, Bill",0,Away
2227,1961-03-24,1960.0,Liverpool,Plymouth Argyle,1-1,1,1,2,2,2,0,D,"Shankly, Bill",1,Anfield
2228,1961-03-31,1960.0,Liverpool,Bristol Rovers,3-0,3,0,2,2,3,3,H,"Shankly, Bill",3,Anfield
2229,1961-04-01,1960.0,Sheffield United,Liverpool,1-1,1,1,2,2,2,0,D,"Shankly, Bill",1,Away
2230,1961-04-04,1960.0,Bristol Rovers,Liverpool,4-3,4,3,2,2,7,1,H,"Shankly, Bill",3,Away
2231,1961-04-08,1960.0,Liverpool,Charlton Athletic,2-1,2,1,2,2,3,1,H,"Shankly, Bill",2,Anfield
2232,1961-04-15,1960.0,Norwich City,Liverpool,2-1,2,1,2,2,3,1,H,"Shankly, Bill",1,Away
2233,1961-04-22,1960.0,Liverpool,Stoke City,3-0,3,0,2,2,3,3,H,"Shankly, Bill",3,Anfield
2234,1961-04-29,1960.0,Sunderland,Liverpool,1-1,1,1,2,2,2,0,D,"Shankly, Bill",1,Away
2235,1961-05-03,1960.0,Stoke City,Liverpool,3-1,3,1,2,2,4,2,H,"Shankly, Bill",1,Away
2236,1961-08-19,1961.0,Bristol Rovers,Liverpool,0-2,0,2,2,2,2,-2,A,"Shankly, Bill",2,Away
2237,1961-08-23,1961.0,Liverpool,Sunderland,3-0,3,0,2,2,3,3,H,"Shankly, Bill",3,Anfield
2238,1961-08-26,1961.0,Liverpool,Leeds United,5-0,5,0,2,2,5,5,H,"Shankly, Bill",5,Anfield
2239,1961-08-30,1961.0,Sunderland,Liverpool,1-4,1,4,2,2,5,-3,A,"Shankly, Bill",4,Away
2240,1961-09-02,1961.0,Norwich City,Liverpool,1-2,1,2,2,2,3,-1,A,"Shankly, Bill",2,Away
2241,1961-09-09,1961.0,Liverpool,Scunthorpe United,2-1,2,1,2,2,3,1,H,"Shankly, Bill",2,Anfield
2242,1961-09-16,1961.0,Brighton & Hove Albion,Liverpool,0-0,0,0,2,2,0,0,D,"Shankly, Bill",0,Away
2243,1961-09-20,1961.0,Newcastle United,Liverpool,1-2,1,2,2,2,3,-1,A,"Shankly, Bill",2,Away
2244,1961-09-23,1961.0,Liverpool,Bury,5-0,5,0,2,2,5,5,H,"Shankly, Bill",5,Anfield
2245,1961-09-30,1961.0,Charlton Athletic,Liverpool,0-4,0,4,2,2,4,-4,A,"Shankly, Bill",4,Away
2246,1961-10-04,1961.0,Liverpool,Newcastle United,2-0,2,0,2,2,2,2,H,"Shankly, Bill",2,Anfield
2247,1961-10-07,1961.0,Middlesbrough,Liverpool,2-0,2,0,2,2,2,2,H,"Shankly, Bill",0,Away
2248,1961-10-14,1961.0,Liverpool,Walsall,6-1,6,1,2,2,7,5,H,"Shankly, Bill",6,Anfield
2249,1961-10-21,1961.0,Derby County,Liverpool,2-0,2,0,2,2,2,2,H,"Shankly, Bill",0,Away
2250,1961-10-28,1961.0,Liverpool,Leyton Orient,3-3,3,3,2,2,6,0,D,"Shankly, Bill",3,Anfield
2251,1961-11-04,1961.0,Preston North End,Liverpool,1-3,1,3,2,2,4,-2,A,"Shankly, Bill",3,Away
2252,1961-11-11,1961.0,Liverpool,Luton Town,1-1,1,1,2,2,2,0,D,"Shankly, Bill",1,Anfield
2253,1961-11-18,1961.0,Huddersfield Town,Liverpool,1-2,1,2,2,2,3,-1,A,"Shankly, Bill",2,Away
2254,1961-11-25,1961.0,Liverpool,Swansea City,5-0,5,0,2,2,5,5,H,"Shankly, Bill",5,Anfield
2255,1961-12-02,1961.0,Southampton,Liverpool,2-0,2,0,2,2,2,2,H,"Shankly, Bill",0,Away
2256,1961-12-09,1961.0,Liverpool,Plymouth Argyle,2-1,2,1,2,2,3,1,H,"Shankly, Bill",2,Anfield
2257,1961-12-16,1961.0,Liverpool,Bristol Rovers,2-0,2,0,2,2,2,2,H,"Shankly, Bill",2,Anfield
2258,1961-12-23,1961.0,Leeds United,Liverpool,1-0,1,0,2,2,1,1,H,"Shankly, Bill",0,Away
2259,1961-12-26,1961.0,Rotherham United,Liverpool,1-0,1,0,2,2,1,1,H,"Shankly, Bill",0,Away
2260,1962-01-13,1961.0,Liverpool,Norwich City,5-4,5,4,2,2,9,1,H,"Shankly, Bill",5,Anfield
2261,1962-01-20,1961.0,Scunthorpe United,Liverpool,1-1,1,1,2,2,2,0,D,"Shankly, Bill",1,Away
2262,1962-02-03,1961.0,Liverpool,Brighton & Hove Albion,3-1,3,1,2,2,4,2,H,"Shankly, Bill",3,Anfield
2263,1962-02-10,1961.0,Bury,Liverpool,0-3,0,3,2,2,3,-3,A,"Shankly, Bill",3,Away
2264,1962-02-24,1961.0,Liverpool,Middlesbrough,5-1,5,1,2,2,6,4,H,"Shankly, Bill",5,Anfield
2265,1962-03-03,1961.0,Walsall,Liverpool,1-1,1,1,2,2,2,0,D,"Shankly, Bill",1,Away
2266,1962-03-10,1961.0,Liverpool,Derby County,4-1,4,1,2,2,5,3,H,"Shankly, Bill",4,Anfield
2267,1962-03-17,1961.0,Leyton Orient,Liverpool,2-2,2,2,2,2,4,0,D,"Shankly, Bill",2,Away
2268,1962-03-24,1961.0,Liverpool,Preston North End,4-1,4,1,2,2,5,3,H,"Shankly, Bill",4,Anfield
2269,1962-03-28,1961.0,Liverpool,Rotherham United,4-1,4,1,2,2,5,3,H,"Shankly, Bill",4,Anfield
2270,1962-03-31,1961.0,Luton Town,Liverpool,1-0,1,0,2,2,1,1,H,"Shankly, Bill",0,Away
2271,1962-04-07,1961.0,Liverpool,Huddersfield Town,1-1,1,1,2,2,2,0,D,"Shankly, Bill",1,Anfield
2272,1962-04-21,1961.0,Liverpool,Southampton,2-0,2,0,2,2,2,2,H,"Shankly, Bill",2,Anfield
2273,1962-04-23,1961.0,Liverpool,Stoke City,2-1,2,1,2,2,3,1,H,"Shankly, Bill",2,Anfield
2274,1962-04-24,1961.0,Stoke City,Liverpool,0-0,0,0,2,2,0,0,D,"Shankly, Bill",0,Away
2275,1962-04-28,1961.0,Plymouth Argyle,Liverpool,2-3,2,3,2,2,5,-1,A,"Shankly, Bill",3,Away
2276,1962-04-30,1961.0,Liverpool,Charlton Athletic,2-1,2,1,2,2,3,1,H,"Shankly, Bill",2,Anfield
2277,1962-05-04,1961.0,Swansea City,Liverpool,4-2,4,2,2,2,6,2,H,"Shankly, Bill",2,Away
2278,1962-08-18,1962.0,Liverpool,Blackpool,1-2,1,2,1,1,3,-1,A,"Shankly, Bill",1,Anfield
2279,1962-08-22,1962.0,Manchester City,Liverpool,2-2,2,2,1,1,4,0,D,"Shankly, Bill",2,Away
2280,1962-08-25,1962.0,Blackburn Rovers,Liverpool,1-0,1,0,1,1,1,1,H,"Shankly, Bill",0,Away
2281,1962-08-29,1962.0,Liverpool,Manchester City,4-1,4,1,1,1,5,3,H,"Shankly, Bill",4,Anfield
2282,1962-09-01,1962.0,Liverpool,Sheffield United,2-0,2,0,1,1,2,2,H,"Shankly, Bill",2,Anfield
2283,1962-09-03,1962.0,West Ham United,Liverpool,1-0,1,0,1,1,1,1,H,"Shankly, Bill",0,Away
2284,1962-09-08,1962.0,Nottingham Forest,Liverpool,3-1,3,1,1,1,4,2,H,"Shankly, Bill",1,Away
2285,1962-09-12,1962.0,Liverpool,West Ham United,2-1,2,1,1,1,3,1,H,"Shankly, Bill",2,Anfield
2286,1962-09-15,1962.0,Liverpool,Ipswich Town,1-1,1,1,1,1,2,0,D,"Shankly, Bill",1,Anfield
2287,1962-09-22,1962.0,Everton,Liverpool,2-2,2,2,1,1,4,0,D,"Shankly, Bill",2,Away
2288,1962-09-29,1962.0,Wolverhampton Wanderers,Liverpool,3-2,3,2,1,1,5,1,H,"Shankly, Bill",2,Away
2289,1962-10-06,1962.0,Liverpool,Bolton Wanderers,1-0,1,0,1,1,1,1,H,"Shankly, Bill",1,Anfield
2290,1962-10-13,1962.0,Leicester City,Liverpool,3-0,3,0,1,1,3,3,H,"Shankly, Bill",0,Away
2291,1962-10-27,1962.0,West Bromwich Albion,Liverpool,1-0,1,0,1,1,1,1,H,"Shankly, Bill",0,Away
2292,1962-11-03,1962.0,Liverpool,Burnley,1-2,1,2,1,1,3,-1,A,"Shankly, Bill",1,Anfield
2293,1962-11-10,1962.0,Manchester United,Liverpool,3-3,3,3,1,1,6,0,D,"Shankly, Bill",3,Away
2294,1962-11-14,1962.0,Liverpool,Arsenal,2-1,2,1,1,1,3,1,H,"Shankly, Bill",2,Anfield
2295,1962-11-17,1962.0,Liverpool,Leyton Orient,5-0,5,0,1,1,5,5,H,"Shankly, Bill",5,Anfield
2296,1962-11-24,1962.0,Birmingham City,Liverpool,0-2,0,2,1,1,2,-2,A,"Shankly, Bill",2,Away
2297,1962-12-01,1962.0,Liverpool,Fulham,2-1,2,1,1,1,3,1,H,"Shankly, Bill",2,Anfield
2298,1962-12-08,1962.0,Sheffield Wednesday,Liverpool,0-2,0,2,1,1,2,-2,A,"Shankly, Bill",2,Away
2299,1962-12-15,1962.0,Blackpool,Liverpool,1-2,1,2,1,1,3,-1,A,"Shankly, Bill",2,Away
2300,1962-12-22,1962.0,Liverpool,Blackburn Rovers,3-1,3,1,1,1,4,2,H,"Shankly, Bill",3,Anfield
2301,1963-02-13,1962.0,Liverpool,Aston Villa,4-0,4,0,1,1,4,4,H,"Shankly, Bill",4,Anfield
2302,1963-02-16,1962.0,Liverpool,Wolverhampton Wanderers,4-1,4,1,1,1,5,3,H,"Shankly, Bill",4,Anfield
2303,1963-03-02,1962.0,Liverpool,Leicester City,0-2,0,2,1,1,2,-2,A,"Shankly, Bill",0,Anfield
2304,1963-03-05,1962.0,Ipswich Town,Liverpool,2-2,2,2,1,1,4,0,D,"Shankly, Bill",2,Away
2305,1963-03-09,1962.0,Arsenal,Liverpool,2-2,2,2,1,1,4,0,D,"Shankly, Bill",2,Away
2306,1963-03-20,1962.0,Liverpool,West Bromwich Albion,2-2,2,2,1,1,4,0,D,"Shankly, Bill",2,Anfield
2307,1963-03-23,1962.0,Burnley,Liverpool,1-3,1,3,1,1,4,-2,A,"Shankly, Bill",3,Away
2308,1963-04-08,1962.0,Liverpool,Everton,0-0,0,0,1,1,0,0,D,"Shankly, Bill",0,Anfield
2309,1963-04-12,1962.0,Liverpool,Tottenham Hotspur,5-2,5,2,1,1,7,3,H,"Shankly, Bill",5,Anfield
2310,1963-04-13,1962.0,Liverpool,Manchester United,1-0,1,0,1,1,1,1,H,"Shankly, Bill",1,Anfield
2311,1963-04-15,1962.0,Tottenham Hotspur,Liverpool,7-2,7,2,1,1,9,5,H,"Shankly, Bill",2,Away
2312,1963-04-18,1962.0,Liverpool,Nottingham Forest,0-2,0,2,1,1,2,-2,A,"Shankly, Bill",0,Anfield
2313,1963-04-20,1962.0,Fulham,Liverpool,0-0,0,0,1,1,0,0,D,"Shankly, Bill",0,Away
2314,1963-04-29,1962.0,Liverpool,Sheffield Wednesday,0-2,0,2,1,1,2,-2,A,"Shankly, Bill",0,Anfield
2315,1963-05-02,1962.0,Leyton Orient,Liverpool,2-1,2,1,1,1,3,1,H,"Shankly, Bill",1,Away
2316,1963-05-08,1962.0,Liverpool,Birmingham City,5-1,5,1,1,1,6,4,H,"Shankly, Bill",5,Anfield
2317,1963-05-11,1962.0,Sheffield United,Liverpool,0-0,0,0,1,1,0,0,D,"Shankly, Bill",0,Away
2318,1963-05-13,1962.0,Bolton Wanderers,Liverpool,1-0,1,0,1,1,1,1,H,"Shankly, Bill",0,Away
2319,1963-05-18,1962.0,Aston Villa,Liverpool,2-0,2,0,1,1,2,2,H,"Shankly, Bill",0,Away
2320,1963-08-24,1963.0,Blackburn Rovers,Liverpool,1-2,1,2,1,1,3,-1,A,"Shankly, Bill",2,Away
2321,1963-08-28,1963.0,Liverpool,Nottingham Forest,1-2,1,2,1,1,3,-1,A,"Shankly, Bill",1,Anfield
2322,1963-08-31,1963.0,Liverpool,Blackpool,1-2,1,2,1,1,3,-1,A,"Shankly, Bill",1,Anfield
2323,1963-09-03,1963.0,Nottingham Forest,Liverpool,0-0,0,0,1,1,0,0,D,"Shankly, Bill",0,Away
2324,1963-09-07,1963.0,Chelsea,Liverpool,1-3,1,3,1,1,4,-2,A,"Shankly, Bill",3,Away
2325,1963-09-09,1963.0,Wolverhampton Wanderers,Liverpool,1-3,1,3,1,1,4,-2,A,"Shankly, Bill",3,Away
2326,1963-09-14,1963.0,Liverpool,West Ham United,1-2,1,2,1,1,3,-1,A,"Shankly, Bill",1,Anfield
2327,1963-09-16,1963.0,Liverpool,Wolverhampton Wanderers,6-0,6,0,1,1,6,6,H,"Shankly, Bill",6,Anfield
2328,1963-09-21,1963.0,Sheffield United,Liverpool,3-0,3,0,1,1,3,3,H,"Shankly, Bill",0,Away
2329,1963-09-28,1963.0,Liverpool,Everton,2-1,2,1,1,1,3,1,H,"Shankly, Bill",2,Anfield
2330,1963-10-05,1963.0,Liverpool,Aston Villa,5-2,5,2,1,1,7,3,H,"Shankly, Bill",5,Anfield
2331,1963-10-09,1963.0,Liverpool,Sheffield Wednesday,3-1,3,1,1,1,4,2,H,"Shankly, Bill",3,Anfield
2332,1963-10-19,1963.0,Liverpool,West Bromwich Albion,1-0,1,0,1,1,1,1,H,"Shankly, Bill",1,Anfield
2333,1963-10-26,1963.0,Ipswich Town,Liverpool,1-2,1,2,1,1,3,-1,A,"Shankly, Bill",2,Away
2334,1963-11-02,1963.0,Liverpool,Leicester City,0-1,0,1,1,1,1,-1,A,"Shankly, Bill",0,Anfield
2335,1963-11-09,1963.0,Bolton Wanderers,Liverpool,1-2,1,2,1,1,3,-1,A,"Shankly, Bill",2,Away
2336,1963-11-16,1963.0,Liverpool,Fulham,2-0,2,0,1,1,2,2,H,"Shankly, Bill",2,Anfield
2337,1963-11-23,1963.0,Manchester United,Liverpool,0-1,0,1,1,1,1,-1,A,"Shankly, Bill",1,Away
2338,1963-11-30,1963.0,Liverpool,Burnley,2-0,2,0,1,1,2,2,H,"Shankly, Bill",2,Anfield
2339,1963-12-07,1963.0,Arsenal,Liverpool,1-1,1,1,1,1,2,0,D,"Shankly, Bill",1,Away
2340,1963-12-14,1963.0,Liverpool,Blackburn Rovers,1-2,1,2,1,1,3,-1,A,"Shankly, Bill",1,Anfield
2341,1963-12-21,1963.0,Blackpool,Liverpool,0-1,0,1,1,1,1,-1,A,"Shankly, Bill",1,Away
2342,1963-12-26,1963.0,Liverpool,Stoke City,6-1,6,1,1,1,7,5,H,"Shankly, Bill",6,Anfield
2343,1964-01-11,1963.0,Liverpool,Chelsea,2-1,2,1,1,1,3,1,H,"Shankly, Bill",2,Anfield
2344,1964-01-18,1963.0,West Ham United,Liverpool,1-0,1,0,1,1,1,1,H,"Shankly, Bill",0,Away
2345,1964-02-01,1963.0,Liverpool,Sheffield United,6-1,6,1,1,1,7,5,H,"Shankly, Bill",6,Anfield
2346,1964-02-08,1963.0,Everton,Liverpool,3-1,3,1,1,1,4,2,H,"Shankly, Bill",1,Away
2347,1964-02-19,1963.0,Aston Villa,Liverpool,2-2,2,2,1,1,4,0,D,"Shankly, Bill",2,Away
2348,1964-02-22,1963.0,Liverpool,Birmingham City,2-1,2,1,1,1,3,1,H,"Shankly, Bill",2,Anfield
2349,1964-03-04,1963.0,Sheffield Wednesday,Liverpool,2-2,2,2,1,1,4,0,D,"Shankly, Bill",2,Away
2350,1964-03-07,1963.0,Liverpool,Ipswich Town,6-0,6,0,1,1,6,6,H,"Shankly, Bill",6,Anfield
2351,1964-03-14,1963.0,Fulham,Liverpool,1-0,1,0,1,1,1,1,H,"Shankly, Bill",0,Away
2352,1964-03-20,1963.0,Liverpool,Bolton Wanderers,2-0,2,0,1,1,2,2,H,"Shankly, Bill",2,Anfield
2353,1964-03-27,1963.0,Tottenham Hotspur,Liverpool,1-3,1,3,1,1,4,-2,A,"Shankly, Bill",3,Away
2354,1964-03-28,1963.0,Leicester City,Liverpool,0-2,0,2,1,1,2,-2,A,"Shankly, Bill",2,Away
2355,1964-03-30,1963.0,Liverpool,Tottenham Hotspur,3-1,3,1,1,1,4,2,H,"Shankly, Bill",3,Anfield
2356,1964-04-04,1963.0,Liverpool,Manchester United,3-0,3,0,1,1,3,3,H,"Shankly, Bill",3,Anfield
2357,1964-04-14,1963.0,Burnley,Liverpool,0-3,0,3,1,1,3,-3,A,"Shankly, Bill",3,Away
2358,1964-04-18,1963.0,Liverpool,Arsenal,5-0,5,0,1,1,5,5,H,"Shankly, Bill",5,Anfield
2359,1964-04-22,1963.0,Birmingham City,Liverpool,3-1,3,1,1,1,4,2,H,"Shankly, Bill",1,Away
2360,1964-04-25,1963.0,West Bromwich Albion,Liverpool,2-2,2,2,1,1,4,0,D,"Shankly, Bill",2,Away
2361,1964-04-29,1963.0,Stoke City,Liverpool,3-1,3,1,1,1,4,2,H,"Shankly, Bill",1,Away
2362,1964-08-22,1964.0,Liverpool,Arsenal,3-2,3,2,1,1,5,1,H,"Shankly, Bill",3,Anfield
2363,1964-08-26,1964.0,Leeds United,Liverpool,4-2,4,2,1,1,6,2,H,"Shankly, Bill",2,Away
2364,1964-08-29,1964.0,Blackburn Rovers,Liverpool,3-2,3,2,1,1,5,1,H,"Shankly, Bill",2,Away
2365,1964-09-02,1964.0,Liverpool,Leeds United,2-1,2,1,1,1,3,1,H,"Shankly, Bill",2,Anfield
2366,1964-09-05,1964.0,Liverpool,Blackpool,2-2,2,2,1,1,4,0,D,"Shankly, Bill",2,Anfield
2367,1964-09-09,1964.0,Leicester City,Liverpool,2-0,2,0,1,1,2,2,H,"Shankly, Bill",0,Away
2368,1964-09-12,1964.0,Sheffield Wednesday,Liverpool,1-0,1,0,1,1,1,1,H,"Shankly, Bill",0,Away
2369,1964-09-19,1964.0,Liverpool,Everton,0-4,0,4,1,1,4,-4,A,"Shankly, Bill",0,Anfield
2370,1964-09-26,1964.0,Liverpool,Aston Villa,5-1,5,1,1,1,6,4,H,"Shankly, Bill",5,Anfield
2371,1964-10-07,1964.0,Liverpool,Sheffield United,3-1,3,1,1,1,4,2,H,"Shankly, Bill",3,Anfield
2372,1964-10-10,1964.0,Birmingham City,Liverpool,0-0,0,0,1,1,0,0,D,"Shankly, Bill",0,Away
2373,1964-10-13,1964.0,Liverpool,Leicester City,0-1,0,1,1,1,1,-1,A,"Shankly, Bill",0,Anfield
2374,1964-10-17,1964.0,Liverpool,West Ham United,2-2,2,2,1,1,4,0,D,"Shankly, Bill",2,Anfield
2375,1964-10-24,1964.0,West Bromwich Albion,Liverpool,3-0,3,0,1,1,3,3,H,"Shankly, Bill",0,Away
2376,1964-10-31,1964.0,Liverpool,Manchester United,0-2,0,2,1,1,2,-2,A,"Shankly, Bill",0,Anfield
2377,1964-11-07,1964.0,Fulham,Liverpool,1-1,1,1,1,1,2,0,D,"Shankly, Bill",1,Away
2378,1964-11-14,1964.0,Liverpool,Nottingham Forest,2-0,2,0,1,1,2,2,H,"Shankly, Bill",2,Anfield
2379,1964-11-21,1964.0,Stoke City,Liverpool,1-1,1,1,1,1,2,0,D,"Shankly, Bill",1,Away
2380,1964-11-28,1964.0,Liverpool,Tottenham Hotspur,1-1,1,1,1,1,2,0,D,"Shankly, Bill",1,Anfield
2381,1964-12-05,1964.0,Burnley,Liverpool,1-5,1,5,1,1,6,-4,A,"Shankly, Bill",5,Away
2382,1964-12-12,1964.0,Arsenal,Liverpool,0-0,0,0,1,1,0,0,D,"Shankly, Bill",0,Away
2383,1964-12-19,1964.0,Liverpool,Blackburn Rovers,3-2,3,2,1,1,5,1,H,"Shankly, Bill",3,Anfield
2384,1964-12-26,1964.0,Sunderland,Liverpool,2-3,2,3,1,1,5,-1,A,"Shankly, Bill",3,Away
2385,1964-12-28,1964.0,Liverpool,Sunderland,0-0,0,0,1,1,0,0,D,"Shankly, Bill",0,Anfield
2386,1965-01-02,1964.0,Blackpool,Liverpool,2-3,2,3,1,1,5,-1,A,"Shankly, Bill",3,Away
2387,1965-01-16,1964.0,Liverpool,Sheffield Wednesday,4-2,4,2,1,1,6,2,H,"Shankly, Bill",4,Anfield
2388,1965-02-06,1964.0,Aston Villa,Liverpool,0-1,0,1,1,1,1,-1,A,"Shankly, Bill",1,Away
2389,1965-02-13,1964.0,Liverpool,Wolverhampton Wanderers,2-1,2,1,1,1,3,1,H,"Shankly, Bill",2,Anfield
2390,1965-02-24,1964.0,Liverpool,Birmingham City,4-3,4,3,1,1,7,1,H,"Shankly, Bill",4,Anfield
2391,1965-02-27,1964.0,West Ham United,Liverpool,2-1,2,1,1,1,3,1,H,"Shankly, Bill",1,Away
2392,1965-03-13,1964.0,Sheffield United,Liverpool,3-0,3,0,1,1,3,3,H,"Shankly, Bill",0,Away
2393,1965-03-20,1964.0,Liverpool,Fulham,3-2,3,2,1,1,5,1,H,"Shankly, Bill",3,Anfield
2394,1965-04-01,1964.0,Nottingham Forest,Liverpool,2-2,2,2,1,1,4,0,D,"Shankly, Bill",2,Away
2395,1965-04-03,1964.0,Liverpool,Stoke City,3-2,3,2,1,1,5,1,H,"Shankly, Bill",3,Anfield
2396,1965-04-06,1964.0,Liverpool,West Bromwich Albion,0-3,0,3,1,1,3,-3,A,"Shankly, Bill",0,Anfield
2397,1965-04-09,1964.0,Tottenham Hotspur,Liverpool,3-0,3,0,1,1,3,3,H,"Shankly, Bill",0,Away
2398,1965-04-12,1964.0,Everton,Liverpool,2-1,2,1,1,1,3,1,H,"Shankly, Bill",1,Away
2399,1965-04-16,1964.0,Chelsea,Liverpool,4-0,4,0,1,1,4,4,H,"Shankly, Bill",0,Away
2400,1965-04-17,1964.0,Liverpool,Burnley,1-1,1,1,1,1,2,0,D,"Shankly, Bill",1,Anfield
2401,1965-04-19,1964.0,Liverpool,Chelsea,2-0,2,0,1,1,2,2,H,"Shankly, Bill",2,Anfield
2402,1965-04-24,1964.0,Manchester United,Liverpool,3-0,3,0,1,1,3,3,H,"Shankly, Bill",0,Away
2403,1965-04-26,1964.0,Wolverhampton Wanderers,Liverpool,1-3,1,3,1,1,4,-2,A,"Shankly, Bill",3,Away
2404,1965-08-21,1965.0,Leicester City,Liverpool,1-3,1,3,1,1,4,-2,A,"Shankly, Bill",3,Away
2405,1965-08-25,1965.0,Liverpool,Sheffield United,0-1,0,1,1,1,1,-1,A,"Shankly, Bill",0,Anfield
2406,1965-09-01,1965.0,Sheffield United,Liverpool,0-0,0,0,1,1,0,0,D,"Shankly, Bill",0,Away
2407,1965-09-04,1965.0,Blackpool,Liverpool,2-3,2,3,1,1,5,-1,A,"Shankly, Bill",3,Away
2408,1965-09-06,1965.0,West Ham United,Liverpool,1-5,1,5,1,1,6,-4,A,"Shankly, Bill",5,Away
2409,1965-09-11,1965.0,Liverpool,Fulham,2-1,2,1,1,1,3,1,H,"Shankly, Bill",2,Anfield
2410,1965-09-15,1965.0,Liverpool,West Ham United,1-1,1,1,1,1,2,0,D,"Shankly, Bill",1,Anfield
2411,1965-09-18,1965.0,Tottenham Hotspur,Liverpool,2-1,2,1,1,1,3,1,H,"Shankly, Bill",1,Away
2412,1965-09-25,1965.0,Liverpool,Everton,5-0,5,0,1,1,5,5,H,"Shankly, Bill",5,Anfield
2413,1965-10-02,1965.0,Liverpool,Aston Villa,3-1,3,1,1,1,4,2,H,"Shankly, Bill",3,Anfield
2414,1965-10-09,1965.0,Manchester United,Liverpool,2-0,2,0,1,1,2,2,H,"Shankly, Bill",0,Away
2415,1965-10-16,1965.0,Liverpool,Newcastle United,2-0,2,0,1,1,2,2,H,"Shankly, Bill",2,Anfield
2416,1965-10-23,1965.0,West Bromwich Albion,Liverpool,3-0,3,0,1,1,3,3,H,"Shankly, Bill",0,Away
2417,1965-10-30,1965.0,Liverpool,Nottingham Forest,4-0,4,0,1,1,4,4,H,"Shankly, Bill",4,Anfield
2418,1965-11-06,1965.0,Sheffield Wednesday,Liverpool,0-2,0,2,1,1,2,-2,A,"Shankly, Bill",2,Away
2419,1965-11-13,1965.0,Liverpool,Northampton Town,5-0,5,0,1,1,5,5,H,"Shankly, Bill",5,Anfield
2420,1965-11-17,1965.0,Liverpool,Blackburn Rovers,5-2,5,2,1,1,7,3,H,"Shankly, Bill",5,Anfield
2421,1965-11-20,1965.0,Stoke City,Liverpool,0-0,0,0,1,1,0,0,D,"Shankly, Bill",0,Away
2422,1965-11-27,1965.0,Liverpool,Burnley,2-1,2,1,1,1,3,1,H,"Shankly, Bill",2,Anfield
2423,1965-12-04,1965.0,Chelsea,Liverpool,0-1,0,1,1,1,1,-1,A,"Shankly, Bill",1,Away
2424,1965-12-11,1965.0,Liverpool,Arsenal,4-2,4,2,1,1,6,2,H,"Shankly, Bill",4,Anfield
2425,1965-12-18,1965.0,Newcastle United,Liverpool,0-0,0,0,1,1,0,0,D,"Shankly, Bill",0,Away
2426,1965-12-27,1965.0,Liverpool,Leeds United,0-1,0,1,1,1,1,-1,A,"Shankly, Bill",0,Anfield
2427,1965-12-28,1965.0,Leeds United,Liverpool,0-1,0,1,1,1,1,-1,A,"Shankly, Bill",1,Away
2428,1966-01-01,1965.0,Liverpool,Manchester United,2-1,2,1,1,1,3,1,H,"Shankly, Bill",2,Anfield
2429,1966-01-08,1965.0,Arsenal,Liverpool,0-1,0,1,1,1,1,-1,A,"Shankly, Bill",1,Away
2430,1966-01-15,1965.0,Liverpool,West Bromwich Albion,2-2,2,2,1,1,4,0,D,"Shankly, Bill",2,Anfield
2431,1966-01-29,1965.0,Liverpool,Leicester City,1-0,1,0,1,1,1,1,H,"Shankly, Bill",1,Anfield
2432,1966-02-05,1965.0,Blackburn Rovers,Liverpool,1-4,1,4,1,1,5,-3,A,"Shankly, Bill",4,Away
2433,1966-02-12,1965.0,Liverpool,Sunderland,4-0,4,0,1,1,4,4,H,"Shankly, Bill",4,Anfield
2434,1966-02-19,1965.0,Liverpool,Blackpool,4-1,4,1,1,1,5,3,H,"Shankly, Bill",4,Anfield
2435,1966-02-26,1965.0,Fulham,Liverpool,2-0,2,0,1,1,2,2,H,"Shankly, Bill",0,Away
2436,1966-03-12,1965.0,Liverpool,Tottenham Hotspur,1-0,1,0,1,1,1,1,H,"Shankly, Bill",1,Anfield
2437,1966-03-19,1965.0,Everton,Liverpool,0-0,0,0,1,1,0,0,D,"Shankly, Bill",0,Away
2438,1966-03-26,1965.0,Aston Villa,Liverpool,0-3,0,3,1,1,3,-3,A,"Shankly, Bill",3,Away
2439,1966-04-06,1965.0,Liverpool,Sheffield Wednesday,1-0,1,0,1,1,1,1,H,"Shankly, Bill",1,Anfield
2440,1966-04-09,1965.0,Northampton Town,Liverpool,0-0,0,0,1,1,0,0,D,"Shankly, Bill",0,Away
2441,1966-04-11,1965.0,Sunderland,Liverpool,2-2,2,2,1,1,4,0,D,"Shankly, Bill",2,Away
2442,1966-04-16,1965.0,Liverpool,Stoke City,2-0,2,0,1,1,2,2,H,"Shankly, Bill",2,Anfield
2443,1966-04-23,1965.0,Burnley,Liverpool,2-0,2,0,1,1,2,2,H,"Shankly, Bill",0,Away
2444,1966-04-30,1965.0,Liverpool,Chelsea,2-1,2,1,1,1,3,1,H,"Shankly, Bill",2,Anfield
2445,1966-05-10,1965.0,Nottingham Forest,Liverpool,1-1,1,1,1,1,2,0,D,"Shankly, Bill",1,Away
2446,1966-08-20,1966.0,Liverpool,Leicester City,3-2,3,2,1,1,5,1,H,"Shankly, Bill",3,Anfield
2447,1966-08-24,1966.0,Manchester City,Liverpool,2-1,2,1,1,1,3,1,H,"Shankly, Bill",1,Away
2448,1966-08-27,1966.0,Everton,Liverpool,3-1,3,1,1,1,4,2,H,"Shankly, Bill",1,Away
2449,1966-08-30,1966.0,Liverpool,Manchester City,3-2,3,2,1,1,5,1,H,"Shankly, Bill",3,Anfield
2450,1966-09-03,1966.0,West Ham United,Liverpool,1-1,1,1,1,1,2,0,D,"Shankly, Bill",1,Away
2451,1966-09-05,1966.0,Blackpool,Liverpool,1-2,1,2,1,1,3,-1,A,"Shankly, Bill",2,Away
2452,1966-09-10,1966.0,Liverpool,Sheffield Wednesday,1-1,1,1,1,1,2,0,D,"Shankly, Bill",1,Anfield
2453,1966-09-17,1966.0,Southampton,Liverpool,1-2,1,2,1,1,3,-1,A,"Shankly, Bill",2,Away
2454,1966-09-24,1966.0,Liverpool,Sunderland,2-2,2,2,1,1,4,0,D,"Shankly, Bill",2,Anfield
2455,1966-10-01,1966.0,Aston Villa,Liverpool,2-3,2,3,1,1,5,-1,A,"Shankly, Bill",3,Away
2456,1966-10-08,1966.0,Liverpool,Fulham,2-2,2,2,1,1,4,0,D,"Shankly, Bill",2,Anfield
2457,1966-10-15,1966.0,Nottingham Forest,Liverpool,1-1,1,1,1,1,2,0,D,"Shankly, Bill",1,Away
2458,1966-10-29,1966.0,Stoke City,Liverpool,2-0,2,0,1,1,2,2,H,"Shankly, Bill",0,Away
2459,1966-11-05,1966.0,Liverpool,Nottingham Forest,4-0,4,0,1,1,4,4,H,"Shankly, Bill",4,Anfield
2460,1966-11-09,1966.0,Liverpool,Burnley,2-0,2,0,1,1,2,2,H,"Shankly, Bill",2,Anfield
2461,1966-11-12,1966.0,Newcastle United,Liverpool,0-2,0,2,1,1,2,-2,A,"Shankly, Bill",2,Away
2462,1966-11-19,1966.0,Liverpool,Leeds United,5-0,5,0,1,1,5,5,H,"Shankly, Bill",5,Anfield
2463,1966-11-26,1966.0,West Bromwich Albion,Liverpool,2-1,2,1,1,1,3,1,H,"Shankly, Bill",1,Away
2464,1966-12-03,1966.0,Liverpool,Sheffield United,1-0,1,0,1,1,1,1,H,"Shankly, Bill",1,Anfield
2465,1966-12-10,1966.0,Manchester United,Liverpool,2-2,2,2,1,1,4,0,D,"Shankly, Bill",2,Away
2466,1966-12-24,1966.0,Chelsea,Liverpool,1-2,1,2,1,1,3,-1,A,"Shankly, Bill",2,Away
2467,1966-12-26,1966.0,Liverpool,Chelsea,2-1,2,1,1,1,3,1,H,"Shankly, Bill",2,Anfield
2468,1966-12-31,1966.0,Liverpool,Everton,0-0,0,0,1,1,0,0,D,"Shankly, Bill",0,Anfield
2469,1967-01-07,1966.0,Liverpool,West Ham United,2-0,2,0,1,1,2,2,H,"Shankly, Bill",2,Anfield
2470,1967-01-14,1966.0,Sheffield Wednesday,Liverpool,0-1,0,1,1,1,1,-1,A,"Shankly, Bill",1,Away
2471,1967-01-18,1966.0,Leicester City,Liverpool,2-1,2,1,1,1,3,1,H,"Shankly, Bill",1,Away
2472,1967-01-21,1966.0,Liverpool,Southampton,2-1,2,1,1,1,3,1,H,"Shankly, Bill",2,Anfield
2473,1967-02-04,1966.0,Sunderland,Liverpool,2-2,2,2,1,1,4,0,D,"Shankly, Bill",2,Away
2474,1967-02-11,1966.0,Liverpool,Aston Villa,1-0,1,0,1,1,1,1,H,"Shankly, Bill",1,Anfield
2475,1967-02-25,1966.0,Fulham,Liverpool,2-2,2,2,1,1,4,0,D,"Shankly, Bill",2,Away
2476,1967-03-04,1966.0,Liverpool,Stoke City,2-1,2,1,1,1,3,1,H,"Shankly, Bill",2,Anfield
2477,1967-03-18,1966.0,Burnley,Liverpool,1-0,1,0,1,1,1,1,H,"Shankly, Bill",0,Away
2478,1967-03-25,1966.0,Liverpool,Manchester United,0-0,0,0,1,1,0,0,D,"Shankly, Bill",0,Anfield
2479,1967-03-27,1966.0,Liverpool,Arsenal,0-0,0,0,1,1,0,0,D,"Shankly, Bill",0,Anfield
2480,1967-03-28,1966.0,Arsenal,Liverpool,1-1,1,1,1,1,2,0,D,"Shankly, Bill",1,Away
2481,1967-04-01,1966.0,Tottenham Hotspur,Liverpool,2-1,2,1,1,1,3,1,H,"Shankly, Bill",1,Away
2482,1967-04-07,1966.0,Liverpool,Newcastle United,3-1,3,1,1,1,4,2,H,"Shankly, Bill",3,Anfield
2483,1967-04-22,1966.0,Liverpool,West Bromwich Albion,0-1,0,1,1,1,1,-1,A,"Shankly, Bill",0,Anfield
2484,1967-04-28,1966.0,Sheffield United,Liverpool,0-1,0,1,1,1,1,-1,A,"Shankly, Bill",1,Away
2485,1967-05-03,1966.0,Leeds United,Liverpool,2-1,2,1,1,1,3,1,H,"Shankly, Bill",1,Away
2486,1967-05-06,1966.0,Liverpool,Tottenham Hotspur,0-0,0,0,1,1,0,0,D,"Shankly, Bill",0,Anfield
2487,1967-05-13,1966.0,Liverpool,Blackpool,1-3,1,3,1,1,4,-2,A,"Shankly, Bill",1,Anfield
2488,1967-08-19,1967.0,Manchester City,Liverpool,0-0,0,0,1,1,0,0,D,"Shankly, Bill",0,Away
2489,1967-08-22,1967.0,Liverpool,Arsenal,2-0,2,0,1,1,2,2,H,"Shankly, Bill",2,Anfield
2490,1967-08-26,1967.0,Liverpool,Newcastle United,6-0,6,0,1,1,6,6,H,"Shankly, Bill",6,Anfield
2491,1967-08-28,1967.0,Arsenal,Liverpool,2-0,2,0,1,1,2,2,H,"Shankly, Bill",0,Away
2492,1967-09-02,1967.0,West Bromwich Albion,Liverpool,0-2,0,2,1,1,2,-2,A,"Shankly, Bill",2,Away
2493,1967-09-05,1967.0,Nottingham Forest,Liverpool,0-1,0,1,1,1,1,-1,A,"Shankly, Bill",1,Away
2494,1967-09-09,1967.0,Liverpool,Chelsea,3-1,3,1,1,1,4,2,H,"Shankly, Bill",3,Anfield
2495,1967-09-16,1967.0,Southampton,Liverpool,1-0,1,0,1,1,1,1,H,"Shankly, Bill",0,Away
2496,1967-09-23,1967.0,Liverpool,Everton,1-0,1,0,1,1,1,1,H,"Shankly, Bill",1,Anfield
2497,1967-09-30,1967.0,Liverpool,Stoke City,2-1,2,1,1,1,3,1,H,"Shankly, Bill",2,Anfield
2498,1967-10-07,1967.0,Leicester City,Liverpool,2-1,2,1,1,1,3,1,H,"Shankly, Bill",1,Away
2499,1967-10-14,1967.0,Liverpool,West Ham United,3-1,3,1,1,1,4,2,H,"Shankly, Bill",3,Anfield
2500,1967-10-24,1967.0,Burnley,Liverpool,1-1,1,1,1,1,2,0,D,"Shankly, Bill",1,Away
2501,1967-10-28,1967.0,Liverpool,Sheffield Wednesday,1-0,1,0,1,1,1,1,H,"Shankly, Bill",1,Anfield
2502,1967-11-04,1967.0,Tottenham Hotspur,Liverpool,1-1,1,1,1,1,2,0,D,"Shankly, Bill",1,Away
2503,1967-11-11,1967.0,Liverpool,Manchester United,1-2,1,2,1,1,3,-1,A,"Shankly, Bill",1,Anfield
2504,1967-11-18,1967.0,Sunderland,Liverpool,1-1,1,1,1,1,2,0,D,"Shankly, Bill",1,Away
2505,1967-11-25,1967.0,Liverpool,Wolverhampton Wanderers,2-1,2,1,1,1,3,1,H,"Shankly, Bill",2,Anfield
2506,1967-12-02,1967.0,Fulham,Liverpool,1-1,1,1,1,1,2,0,D,"Shankly, Bill",1,Away
2507,1967-12-09,1967.0,Liverpool,Leeds United,2-0,2,0,1,1,2,2,H,"Shankly, Bill",2,Anfield
2508,1967-12-16,1967.0,Liverpool,Manchester City,1-1,1,1,1,1,2,0,D,"Shankly, Bill",1,Anfield
2509,1967-12-23,1967.0,Newcastle United,Liverpool,1-1,1,1,1,1,2,0,D,"Shankly, Bill",1,Away
2510,1967-12-26,1967.0,Coventry City,Liverpool,1-1,1,1,1,1,2,0,D,"Shankly, Bill",1,Away
2511,1967-12-30,1967.0,Liverpool,Coventry City,1-0,1,0,1,1,1,1,H,"Shankly, Bill",1,Anfield
2512,1968-01-06,1967.0,Liverpool,West Bromwich Albion,4-1,4,1,1,1,5,3,H,"Shankly, Bill",4,Anfield
2513,1968-01-20,1967.0,Liverpool,Southampton,2-0,2,0,1,1,2,2,H,"Shankly, Bill",2,Anfield
2514,1968-02-03,1967.0,Everton,Liverpool,1-0,1,0,1,1,1,1,H,"Shankly, Bill",0,Away
2515,1968-02-12,1967.0,Chelsea,Liverpool,3-1,3,1,1,1,4,2,H,"Shankly, Bill",1,Away
2516,1968-02-24,1967.0,Liverpool,Leicester City,3-1,3,1,1,1,4,2,H,"Shankly, Bill",3,Anfield
2517,1968-03-02,1967.0,Wolverhampton Wanderers,Liverpool,1-1,1,1,1,1,2,0,D,"Shankly, Bill",1,Away
2518,1968-03-16,1967.0,Liverpool,Burnley,3-2,3,2,1,1,5,1,H,"Shankly, Bill",3,Anfield
2519,1968-03-23,1967.0,Sheffield Wednesday,Liverpool,1-2,1,2,1,1,3,-1,A,"Shankly, Bill",2,Away
2520,1968-04-06,1967.0,Manchester United,Liverpool,1-2,1,2,1,1,3,-1,A,"Shankly, Bill",2,Away
2521,1968-04-12,1967.0,Liverpool,Sheffield United,1-2,1,2,1,1,3,-1,A,"Shankly, Bill",1,Anfield
2522,1968-04-13,1967.0,Liverpool,Sunderland,2-1,2,1,1,1,3,1,H,"Shankly, Bill",2,Anfield
2523,1968-04-15,1967.0,Sheffield United,Liverpool,1-1,1,1,1,1,2,0,D,"Shankly, Bill",1,Away
2524,1968-04-20,1967.0,West Ham United,Liverpool,1-0,1,0,1,1,1,1,H,"Shankly, Bill",0,Away
2525,1968-04-27,1967.0,Liverpool,Fulham,4-1,4,1,1,1,5,3,H,"Shankly, Bill",4,Anfield
2526,1968-04-29,1967.0,Liverpool,Tottenham Hotspur,1-1,1,1,1,1,2,0,D,"Shankly, Bill",1,Anfield
2527,1968-05-04,1967.0,Leeds United,Liverpool,1-2,1,2,1,1,3,-1,A,"Shankly, Bill",2,Away
2528,1968-05-11,1967.0,Liverpool,Nottingham Forest,6-1,6,1,1,1,7,5,H,"Shankly, Bill",6,Anfield
2529,1968-05-15,1967.0,Stoke City,Liverpool,2-1,2,1,1,1,3,1,H,"Shankly, Bill",1,Away
2530,1968-08-10,1968.0,Liverpool,Manchester City,2-1,2,1,1,1,3,1,H,"Shankly, Bill",2,Anfield
2531,1968-08-14,1968.0,Southampton,Liverpool,2-0,2,0,1,1,2,2,H,"Shankly, Bill",0,Away
2532,1968-08-17,1968.0,Arsenal,Liverpool,1-1,1,1,1,1,2,0,D,"Shankly, Bill",1,Away
2533,1968-08-20,1968.0,Liverpool,Stoke City,2-1,2,1,1,1,3,1,H,"Shankly, Bill",2,Anfield
2534,1968-08-24,1968.0,Liverpool,Sunderland,4-1,4,1,1,1,5,3,H,"Shankly, Bill",4,Anfield
2535,1968-08-27,1968.0,Everton,Liverpool,0-0,0,0,1,1,0,0,D,"Shankly, Bill",0,Away
2536,1968-08-31,1968.0,Leeds United,Liverpool,1-0,1,0,1,1,1,1,H,"Shankly, Bill",0,Away
2537,1968-09-07,1968.0,Liverpool,Queens Park Rangers,2-0,2,0,1,1,2,2,H,"Shankly, Bill",2,Anfield
2538,1968-09-14,1968.0,Ipswich Town,Liverpool,0-2,0,2,1,1,2,-2,A,"Shankly, Bill",2,Away
2539,1968-09-21,1968.0,Liverpool,Leicester City,4-0,4,0,1,1,4,4,H,"Shankly, Bill",4,Anfield
2540,1968-09-28,1968.0,Wolverhampton Wanderers,Liverpool,0-6,0,6,1,1,6,-6,A,"Shankly, Bill",6,Away
2541,1968-10-05,1968.0,Burnley,Liverpool,0-4,0,4,1,1,4,-4,A,"Shankly, Bill",4,Away
2542,1968-10-08,1968.0,Liverpool,Everton,1-1,1,1,1,1,2,0,D,"Shankly, Bill",1,Anfield
2543,1968-10-12,1968.0,Liverpool,Manchester United,2-0,2,0,1,1,2,2,H,"Shankly, Bill",2,Anfield
2544,1968-10-19,1968.0,Tottenham Hotspur,Liverpool,2-1,2,1,1,1,3,1,H,"Shankly, Bill",1,Away
2545,1968-10-26,1968.0,Liverpool,Newcastle United,2-1,2,1,1,1,3,1,H,"Shankly, Bill",2,Anfield
2546,1968-11-02,1968.0,West Bromwich Albion,Liverpool,0-0,0,0,1,1,0,0,D,"Shankly, Bill",0,Away
2547,1968-11-09,1968.0,Liverpool,Chelsea,2-1,2,1,1,1,3,1,H,"Shankly, Bill",2,Anfield
2548,1968-11-16,1968.0,Sheffield Wednesday,Liverpool,1-2,1,2,1,1,3,-1,A,"Shankly, Bill",2,Away
2549,1968-11-23,1968.0,Liverpool,Coventry City,2-0,2,0,1,1,2,2,H,"Shankly, Bill",2,Anfield
2550,1968-11-30,1968.0,Nottingham Forest,Liverpool,0-1,0,1,1,1,1,-1,A,"Shankly, Bill",1,Away
2551,1968-12-03,1968.0,Liverpool,Southampton,1-0,1,0,1,1,1,1,H,"Shankly, Bill",1,Anfield
2552,1968-12-07,1968.0,Liverpool,West Ham United,2-0,2,0,1,1,2,2,H,"Shankly, Bill",2,Anfield
2553,1968-12-14,1968.0,Manchester United,Liverpool,1-0,1,0,1,1,1,1,H,"Shankly, Bill",0,Away
2554,1968-12-21,1968.0,Liverpool,Tottenham Hotspur,1-0,1,0,1,1,1,1,H,"Shankly, Bill",1,Anfield
2555,1968-12-26,1968.0,Liverpool,Burnley,1-1,1,1,1,1,2,0,D,"Shankly, Bill",1,Anfield
2556,1969-01-11,1968.0,Liverpool,West Bromwich Albion,1-0,1,0,1,1,1,1,H,"Shankly, Bill",1,Anfield
2557,1969-01-18,1968.0,Chelsea,Liverpool,1-2,1,2,1,1,3,-1,A,"Shankly, Bill",2,Away
2558,1969-02-01,1968.0,Liverpool,Sheffield Wednesday,1-0,1,0,1,1,1,1,H,"Shankly, Bill",1,Anfield
2559,1969-02-15,1968.0,Liverpool,Nottingham Forest,0-2,0,2,1,1,2,-2,A,"Shankly, Bill",0,Anfield
2560,1969-02-22,1968.0,West Ham United,Liverpool,1-1,1,1,1,1,2,0,D,"Shankly, Bill",1,Away
2561,1969-03-15,1968.0,Sunderland,Liverpool,0-2,0,2,1,1,2,-2,A,"Shankly, Bill",2,Away
2562,1969-03-29,1968.0,Queens Park Rangers,Liverpool,1-2,1,2,1,1,3,-1,A,"Shankly, Bill",2,Away
2563,1969-03-31,1968.0,Liverpool,Arsenal,1-1,1,1,1,1,2,0,D,"Shankly, Bill",1,Anfield
2564,1969-04-05,1968.0,Liverpool,Wolverhampton Wanderers,1-0,1,0,1,1,1,1,H,"Shankly, Bill",1,Anfield
2565,1969-04-07,1968.0,Stoke City,Liverpool,0-0,0,0,1,1,0,0,D,"Shankly, Bill",0,Away
2566,1969-04-12,1968.0,Leicester City,Liverpool,1-2,1,2,1,1,3,-1,A,"Shankly, Bill",2,Away
2567,1969-04-19,1968.0,Liverpool,Ipswich Town,4-0,4,0,1,1,4,4,H,"Shankly, Bill",4,Anfield
2568,1969-04-22,1968.0,Coventry City,Liverpool,0-0,0,0,1,1,0,0,D,"Shankly, Bill",0,Away
2569,1969-04-28,1968.0,Liverpool,Leeds United,0-0,0,0,1,1,0,0,D,"Shankly, Bill",0,Anfield
2570,1969-05-12,1968.0,Manchester City,Liverpool,1-0,1,0,1,1,1,1,H,"Shankly, Bill",0,Away
2571,1969-05-17,1968.0,Newcastle United,Liverpool,1-1,1,1,1,1,2,0,D,"Shankly, Bill",1,Away
2572,1969-08-09,1969.0,Liverpool,Chelsea,4-1,4,1,1,1,5,3,H,"Shankly, Bill",4,Anfield
2573,1969-08-12,1969.0,Liverpool,Manchester City,3-2,3,2,1,1,5,1,H,"Shankly, Bill",3,Anfield
2574,1969-08-16,1969.0,Tottenham Hotspur,Liverpool,0-2,0,2,1,1,2,-2,A,"Shankly, Bill",2,Away
2575,1969-08-20,1969.0,Manchester City,Liverpool,0-2,0,2,1,1,2,-2,A,"Shankly, Bill",2,Away
2576,1969-08-23,1969.0,Liverpool,Burnley,3-3,3,3,1,1,6,0,D,"Shankly, Bill",3,Anfield
2577,1969-08-27,1969.0,Crystal Palace,Liverpool,1-3,1,3,1,1,4,-2,A,"Shankly, Bill",3,Away
2578,1969-08-30,1969.0,Sheffield Wednesday,Liverpool,1-1,1,1,1,1,2,0,D,"Shankly, Bill",1,Away
2579,1969-09-06,1969.0,Liverpool,Coventry City,2-1,2,1,1,1,3,1,H,"Shankly, Bill",2,Anfield
2580,1969-09-09,1969.0,Liverpool,Sunderland,2-0,2,0,1,1,2,2,H,"Shankly, Bill",2,Anfield
2581,1969-09-13,1969.0,Manchester United,Liverpool,1-0,1,0,1,1,1,1,H,"Shankly, Bill",0,Away
2582,1969-09-20,1969.0,Liverpool,Stoke City,3-1,3,1,1,1,4,2,H,"Shankly, Bill",3,Anfield
2583,1969-09-27,1969.0,West Bromwich Albion,Liverpool,2-2,2,2,1,1,4,0,D,"Shankly, Bill",2,Away
2584,1969-10-04,1969.0,Liverpool,Nottingham Forest,1-1,1,1,1,1,2,0,D,"Shankly, Bill",1,Anfield
2585,1969-10-07,1969.0,Liverpool,Tottenham Hotspur,0-0,0,0,1,1,0,0,D,"Shankly, Bill",0,Anfield
2586,1969-10-11,1969.0,Newcastle United,Liverpool,1-0,1,0,1,1,1,1,H,"Shankly, Bill",0,Away
2587,1969-10-18,1969.0,Ipswich Town,Liverpool,2-2,2,2,1,1,4,0,D,"Shankly, Bill",2,Away
2588,1969-10-25,1969.0,Liverpool,Southampton,4-1,4,1,1,1,5,3,H,"Shankly, Bill",4,Anfield
2589,1969-11-01,1969.0,Derby County,Liverpool,4-0,4,0,1,1,4,4,H,"Shankly, Bill",0,Away
2590,1969-11-08,1969.0,Liverpool,Wolverhampton Wanderers,0-0,0,0,1,1,0,0,D,"Shankly, Bill",0,Anfield
2591,1969-11-15,1969.0,Liverpool,West Ham United,2-0,2,0,1,1,2,2,H,"Shankly, Bill",2,Anfield
2592,1969-11-22,1969.0,Leeds United,Liverpool,1-1,1,1,1,1,2,0,D,"Shankly, Bill",1,Away
2593,1969-11-29,1969.0,Liverpool,Arsenal,0-1,0,1,1,1,1,-1,A,"Shankly, Bill",0,Anfield
2594,1969-12-06,1969.0,Everton,Liverpool,0-3,0,3,1,1,3,-3,A,"Shankly, Bill",3,Away
2595,1969-12-13,1969.0,Liverpool,Manchester United,1-4,1,4,1,1,5,-3,A,"Shankly, Bill",1,Anfield
2596,1969-12-26,1969.0,Burnley,Liverpool,1-5,1,5,1,1,6,-4,A,"Shankly, Bill",5,Away
2597,1970-01-10,1969.0,Stoke City,Liverpool,0-2,0,2,1,1,2,-2,A,"Shankly, Bill",2,Away
2598,1970-01-17,1969.0,Liverpool,West Bromwich Albion,1-1,1,1,1,1,2,0,D,"Shankly, Bill",1,Anfield
2599,1970-01-31,1969.0,Nottingham Forest,Liverpool,1-0,1,0,1,1,1,1,H,"Shankly, Bill",0,Away
2600,1970-02-16,1969.0,Liverpool,Newcastle United,0-0,0,0,1,1,0,0,D,"Shankly, Bill",0,Anfield
2601,1970-02-28,1969.0,Liverpool,Derby County,0-2,0,2,1,1,2,-2,A,"Shankly, Bill",0,Anfield
2602,1970-03-03,1969.0,Coventry City,Liverpool,2-3,2,3,1,1,5,-1,A,"Shankly, Bill",3,Away
2603,1970-03-07,1969.0,Liverpool,Leeds United,0-0,0,0,1,1,0,0,D,"Shankly, Bill",0,Anfield
2604,1970-03-11,1969.0,Southampton,Liverpool,0-1,0,1,1,1,1,-1,A,"Shankly, Bill",1,Away
2605,1970-03-14,1969.0,Arsenal,Liverpool,2-1,2,1,1,1,3,1,H,"Shankly, Bill",1,Away
2606,1970-03-16,1969.0,Liverpool,Sheffield Wednesday,3-0,3,0,1,1,3,3,H,"Shankly, Bill",3,Anfield
2607,1970-03-21,1969.0,Liverpool,Everton,0-2,0,2,1,1,2,-2,A,"Shankly, Bill",0,Anfield
2608,1970-03-24,1969.0,Liverpool,Ipswich Town,2-0,2,0,1,1,2,2,H,"Shankly, Bill",2,Anfield
2609,1970-03-28,1969.0,West Ham United,Liverpool,1-0,1,0,1,1,1,1,H,"Shankly, Bill",0,Away
2610,1970-03-30,1969.0,Wolverhampton Wanderers,Liverpool,0-1,0,1,1,1,1,-1,A,"Shankly, Bill",1,Away
2611,1970-04-03,1969.0,Liverpool,Crystal Palace,3-0,3,0,1,1,3,3,H,"Shankly, Bill",3,Anfield
2612,1970-04-15,1969.0,Sunderland,Liverpool,0-1,0,1,1,1,1,-1,A,"Shankly, Bill",1,Away
2613,1970-04-18,1969.0,Chelsea,Liverpool,2-1,2,1,1,1,3,1,H,"Shankly, Bill",1,Away
2614,1970-08-15,1970.0,Burnley,Liverpool,1-2,1,2,1,1,3,-1,A,"Shankly, Bill",2,Away
2615,1970-08-17,1970.0,Blackpool,Liverpool,0-0,0,0,1,1,0,0,D,"Shankly, Bill",0,Away
2616,1970-08-22,1970.0,Liverpool,Huddersfield Town,4-0,4,0,1,1,4,4,H,"Shankly, Bill",4,Anfield
2617,1970-08-25,1970.0,Liverpool,Crystal Palace,1-1,1,1,1,1,2,0,D,"Shankly, Bill",1,Anfield
2618,1970-08-29,1970.0,West Bromwich Albion,Liverpool,1-1,1,1,1,1,2,0,D,"Shankly, Bill",1,Away
2619,1970-09-05,1970.0,Liverpool,Manchester United,1-1,1,1,1,1,2,0,D,"Shankly, Bill",1,Anfield
2620,1970-09-12,1970.0,Newcastle United,Liverpool,0-0,0,0,1,1,0,0,D,"Shankly, Bill",0,Away
2621,1970-09-19,1970.0,Liverpool,Nottingham Forest,3-0,3,0,1,1,3,3,H,"Shankly, Bill",3,Anfield
2622,1970-09-26,1970.0,Southampton,Liverpool,1-0,1,0,1,1,1,1,H,"Shankly, Bill",0,Away
2623,1970-10-03,1970.0,Liverpool,Chelsea,1-0,1,0,1,1,1,1,H,"Shankly, Bill",1,Anfield
2624,1970-10-10,1970.0,Tottenham Hotspur,Liverpool,1-0,1,0,1,1,1,1,H,"Shankly, Bill",0,Away
2625,1970-10-17,1970.0,Liverpool,Burnley,2-0,2,0,1,1,2,2,H,"Shankly, Bill",2,Anfield
2626,1970-10-24,1970.0,Ipswich Town,Liverpool,1-0,1,0,1,1,1,1,H,"Shankly, Bill",0,Away
2627,1970-10-31,1970.0,Liverpool,Wolverhampton Wanderers,2-0,2,0,1,1,2,2,H,"Shankly, Bill",2,Anfield
2628,1970-11-07,1970.0,Derby County,Liverpool,0-0,0,0,1,1,0,0,D,"Shankly, Bill",0,Away
2629,1970-11-14,1970.0,Liverpool,Coventry City,0-0,0,0,1,1,0,0,D,"Shankly, Bill",0,Anfield
2630,1970-11-21,1970.0,Liverpool,Everton,3-2,3,2,1,1,5,1,H,"Shankly, Bill",3,Anfield
2631,1970-11-28,1970.0,Arsenal,Liverpool,2-0,2,0,1,1,2,2,H,"Shankly, Bill",0,Away
2632,1970-12-05,1970.0,Liverpool,Leeds United,1-1,1,1,1,1,2,0,D,"Shankly, Bill",1,Anfield
2633,1970-12-12,1970.0,West Ham United,Liverpool,1-2,1,2,1,1,3,-1,A,"Shankly, Bill",2,Away
2634,1970-12-19,1970.0,Huddersfield Town,Liverpool,0-0,0,0,1,1,0,0,D,"Shankly, Bill",0,Away
2635,1970-12-26,1970.0,Liverpool,Stoke City,0-0,0,0,1,1,0,0,D,"Shankly, Bill",0,Anfield
2636,1971-01-09,1970.0,Liverpool,Blackpool,2-2,2,2,1,1,4,0,D,"Shankly, Bill",2,Anfield
2637,1971-01-12,1970.0,Liverpool,Manchester City,0-0,0,0,1,1,0,0,D,"Shankly, Bill",0,Anfield
2638,1971-01-16,1970.0,Crystal Palace,Liverpool,1-0,1,0,1,1,1,1,H,"Shankly, Bill",0,Away
2639,1971-01-30,1970.0,Liverpool,Arsenal,2-0,2,0,1,1,2,2,H,"Shankly, Bill",2,Anfield
2640,1971-02-06,1970.0,Leeds United,Liverpool,0-1,0,1,1,1,1,-1,A,"Shankly, Bill",1,Away
2641,1971-02-16,1970.0,Liverpool,West Ham United,1-0,1,0,1,1,1,1,H,"Shankly, Bill",1,Anfield
2642,1971-02-20,1970.0,Everton,Liverpool,0-0,0,0,1,1,0,0,D,"Shankly, Bill",0,Away
2643,1971-02-27,1970.0,Wolverhampton Wanderers,Liverpool,1-0,1,0,1,1,1,1,H,"Shankly, Bill",0,Away
2644,1971-03-13,1970.0,Coventry City,Liverpool,1-0,1,0,1,1,1,1,H,"Shankly, Bill",0,Away
2645,1971-03-20,1970.0,Liverpool,Derby County,2-0,2,0,1,1,2,2,H,"Shankly, Bill",2,Anfield
2646,1971-03-29,1970.0,Liverpool,Ipswich Town,2-1,2,1,1,1,3,1,H,"Shankly, Bill",2,Anfield
2647,1971-04-02,1970.0,Liverpool,West Bromwich Albion,1-1,1,1,1,1,2,0,D,"Shankly, Bill",1,Anfield
2648,1971-04-06,1970.0,Liverpool,Newcastle United,1-1,1,1,1,1,2,0,D,"Shankly, Bill",1,Anfield
2649,1971-04-10,1970.0,Stoke City,Liverpool,0-1,0,1,1,1,1,-1,A,"Shankly, Bill",1,Away
2650,1971-04-12,1970.0,Chelsea,Liverpool,1-0,1,0,1,1,1,1,H,"Shankly, Bill",0,Away
2651,1971-04-17,1970.0,Liverpool,Tottenham Hotspur,0-0,0,0,1,1,0,0,D,"Shankly, Bill",0,Anfield
2652,1971-04-19,1970.0,Manchester United,Liverpool,0-2,0,2,1,1,2,-2,A,"Shankly, Bill",2,Away
2653,1971-04-24,1970.0,Nottingham Forest,Liverpool,0-1,0,1,1,1,1,-1,A,"Shankly, Bill",1,Away
2654,1971-04-26,1970.0,Manchester City,Liverpool,2-2,2,2,1,1,4,0,D,"Shankly, Bill",2,Away
2655,1971-05-01,1970.0,Liverpool,Southampton,1-0,1,0,1,1,1,1,H,"Shankly, Bill",1,Anfield
2656,1971-08-14,1971.0,Liverpool,Nottingham Forest,3-1,3,1,1,1,4,2,H,"Shankly, Bill",3,Anfield
2657,1971-08-17,1971.0,Liverpool,Wolverhampton Wanderers,3-2,3,2,1,1,5,1,H,"Shankly, Bill",3,Anfield
2658,1971-08-21,1971.0,Newcastle United,Liverpool,3-2,3,2,1,1,5,1,H,"Shankly, Bill",2,Away
2659,1971-08-24,1971.0,Crystal Palace,Liverpool,0-1,0,1,1,1,1,-1,A,"Shankly, Bill",1,Away
2660,1971-08-28,1971.0,Liverpool,Leicester City,3-2,3,2,1,1,5,1,H,"Shankly, Bill",3,Anfield
2661,1971-09-01,1971.0,Manchester City,Liverpool,1-0,1,0,1,1,1,1,H,"Shankly, Bill",0,Away
2662,1971-09-04,1971.0,Tottenham Hotspur,Liverpool,2-0,2,0,1,1,2,2,H,"Shankly, Bill",0,Away
2663,1971-09-11,1971.0,Liverpool,Southampton,1-0,1,0,1,1,1,1,H,"Shankly, Bill",1,Anfield
2664,1971-09-18,1971.0,Leeds United,Liverpool,1-0,1,0,1,1,1,1,H,"Shankly, Bill",0,Away
2665,1971-09-25,1971.0,Liverpool,Manchester United,2-2,2,2,1,1,4,0,D,"Shankly, Bill",2,Anfield
2666,1971-10-02,1971.0,Stoke City,Liverpool,0-0,0,0,1,1,0,0,D,"Shankly, Bill",0,Away
2667,1971-10-09,1971.0,Liverpool,Chelsea,0-0,0,0,1,1,0,0,D,"Shankly, Bill",0,Anfield
2668,1971-10-16,1971.0,Nottingham Forest,Liverpool,2-3,2,3,1,1,5,-1,A,"Shankly, Bill",3,Away
2669,1971-10-23,1971.0,Liverpool,Huddersfield Town,2-0,2,0,1,1,2,2,H,"Shankly, Bill",2,Anfield
2670,1971-10-30,1971.0,Sheffield United,Liverpool,1-1,1,1,1,1,2,0,D,"Shankly, Bill",1,Away
2671,1971-11-06,1971.0,Liverpool,Arsenal,3-2,3,2,1,1,5,1,H,"Shankly, Bill",3,Anfield
2672,1971-11-13,1971.0,Everton,Liverpool,1-0,1,0,1,1,1,1,H,"Shankly, Bill",0,Away
2673,1971-11-20,1971.0,Coventry City,Liverpool,0-2,0,2,1,1,2,-2,A,"Shankly, Bill",2,Away
2674,1971-11-27,1971.0,Liverpool,West Ham United,1-0,1,0,1,1,1,1,H,"Shankly, Bill",1,Anfield
2675,1971-12-04,1971.0,Ipswich Town,Liverpool,0-0,0,0,1,1,0,0,D,"Shankly, Bill",0,Away
2676,1971-12-11,1971.0,Liverpool,Derby County,3-2,3,2,1,1,5,1,H,"Shankly, Bill",3,Anfield
2677,1971-12-18,1971.0,Liverpool,Tottenham Hotspur,0-0,0,0,1,1,0,0,D,"Shankly, Bill",0,Anfield
2678,1971-12-27,1971.0,West Bromwich Albion,Liverpool,1-0,1,0,1,1,1,1,H,"Shankly, Bill",0,Away
2679,1972-01-01,1971.0,Liverpool,Leeds United,0-2,0,2,1,1,2,-2,A,"Shankly, Bill",0,Anfield
2680,1972-01-08,1971.0,Leicester City,Liverpool,1-0,1,0,1,1,1,1,H,"Shankly, Bill",0,Away
2681,1972-01-22,1971.0,Wolverhampton Wanderers,Liverpool,0-0,0,0,1,1,0,0,D,"Shankly, Bill",0,Away
2682,1972-01-29,1971.0,Liverpool,Crystal Palace,4-1,4,1,1,1,5,3,H,"Shankly, Bill",4,Anfield
2683,1972-02-12,1971.0,Huddersfield Town,Liverpool,0-1,0,1,1,1,1,-1,A,"Shankly, Bill",1,Away
2684,1972-02-19,1971.0,Liverpool,Sheffield United,2-0,2,0,1,1,2,2,H,"Shankly, Bill",2,Anfield
2685,1972-02-26,1971.0,Liverpool,Manchester City,3-0,3,0,1,1,3,3,H,"Shankly, Bill",3,Anfield
2686,1972-03-04,1971.0,Liverpool,Everton,4-0,4,0,1,1,4,4,H,"Shankly, Bill",4,Anfield
2687,1972-03-11,1971.0,Chelsea,Liverpool,0-0,0,0,1,1,0,0,D,"Shankly, Bill",0,Away
2688,1972-03-18,1971.0,Liverpool,Newcastle United,5-0,5,0,1,1,5,5,H,"Shankly, Bill",5,Anfield
2689,1972-03-25,1971.0,Southampton,Liverpool,0-1,0,1,1,1,1,-1,A,"Shankly, Bill",1,Away
2690,1972-03-28,1971.0,Liverpool,Stoke City,2-1,2,1,1,1,3,1,H,"Shankly, Bill",2,Anfield
2691,1972-04-01,1971.0,Liverpool,West Bromwich Albion,2-0,2,0,1,1,2,2,H,"Shankly, Bill",2,Anfield
2692,1972-04-03,1971.0,Manchester United,Liverpool,0-3,0,3,1,1,3,-3,A,"Shankly, Bill",3,Away
2693,1972-04-08,1971.0,Liverpool,Coventry City,3-1,3,1,1,1,4,2,H,"Shankly, Bill",3,Anfield
2694,1972-04-15,1971.0,West Ham United,Liverpool,0-2,0,2,1,1,2,-2,A,"Shankly, Bill",2,Away
2695,1972-04-22,1971.0,Liverpool,Ipswich Town,2-0,2,0,1,1,2,2,H,"Shankly, Bill",2,Anfield
2696,1972-05-01,1971.0,Derby County,Liverpool,1-0,1,0,1,1,1,1,H,"Shankly, Bill",0,Away
2697,1972-05-08,1971.0,Arsenal,Liverpool,0-0,0,0,1,1,0,0,D,"Shankly, Bill",0,Away
2698,1972-08-12,1972.0,Liverpool,Manchester City,2-0,2,0,1,1,2,2,H,"Shankly, Bill",2,Anfield
2699,1972-08-15,1972.0,Liverpool,Manchester United,2-0,2,0,1,1,2,2,H,"Shankly, Bill",2,Anfield
2700,1972-08-19,1972.0,Crystal Palace,Liverpool,1-1,1,1,1,1,2,0,D,"Shankly, Bill",1,Away
2701,1972-08-23,1972.0,Chelsea,Liverpool,1-2,1,2,1,1,3,-1,A,"Shankly, Bill",2,Away
2702,1972-08-26,1972.0,Liverpool,West Ham United,3-2,3,2,1,1,5,1,H,"Shankly, Bill",3,Anfield
2703,1972-08-30,1972.0,Leicester City,Liverpool,3-2,3,2,1,1,5,1,H,"Shankly, Bill",2,Away
2704,1972-09-02,1972.0,Derby County,Liverpool,2-1,2,1,1,1,3,1,H,"Shankly, Bill",1,Away
2705,1972-09-09,1972.0,Liverpool,Wolverhampton Wanderers,4-2,4,2,1,1,6,2,H,"Shankly, Bill",4,Anfield
2706,1972-09-16,1972.0,Arsenal,Liverpool,0-0,0,0,1,1,0,0,D,"Shankly, Bill",0,Away
2707,1972-09-23,1972.0,Liverpool,Sheffield United,5-0,5,0,1,1,5,5,H,"Shankly, Bill",5,Anfield
2708,1972-09-30,1972.0,Leeds United,Liverpool,1-2,1,2,1,1,3,-1,A,"Shankly, Bill",2,Away
2709,1972-10-07,1972.0,Liverpool,Everton,1-0,1,0,1,1,1,1,H,"Shankly, Bill",1,Anfield
2710,1972-10-14,1972.0,Southampton,Liverpool,1-1,1,1,1,1,2,0,D,"Shankly, Bill",1,Away
2711,1972-10-21,1972.0,Liverpool,Stoke City,2-1,2,1,1,1,3,1,H,"Shankly, Bill",2,Anfield
2712,1972-10-28,1972.0,Norwich City,Liverpool,1-1,1,1,1,1,2,0,D,"Shankly, Bill",1,Away
2713,1972-11-04,1972.0,Liverpool,Chelsea,3-1,3,1,1,1,4,2,H,"Shankly, Bill",3,Anfield
2714,1972-11-11,1972.0,Manchester United,Liverpool,2-0,2,0,1,1,2,2,H,"Shankly, Bill",0,Away
2715,1972-11-18,1972.0,Liverpool,Newcastle United,3-2,3,2,1,1,5,1,H,"Shankly, Bill",3,Anfield
2716,1972-11-25,1972.0,Tottenham Hotspur,Liverpool,1-2,1,2,1,1,3,-1,A,"Shankly, Bill",2,Away
2717,1972-12-02,1972.0,Liverpool,Birmingham City,4-3,4,3,1,1,7,1,H,"Shankly, Bill",4,Anfield
2718,1972-12-09,1972.0,West Bromwich Albion,Liverpool,1-1,1,1,1,1,2,0,D,"Shankly, Bill",1,Away
2719,1972-12-16,1972.0,Ipswich Town,Liverpool,1-1,1,1,1,1,2,0,D,"Shankly, Bill",1,Away
2720,1972-12-23,1972.0,Liverpool,Coventry City,2-0,2,0,1,1,2,2,H,"Shankly, Bill",2,Anfield
2721,1972-12-26,1972.0,Sheffield United,Liverpool,0-3,0,3,1,1,3,-3,A,"Shankly, Bill",3,Away
2722,1972-12-30,1972.0,Liverpool,Crystal Palace,1-0,1,0,1,1,1,1,H,"Shankly, Bill",1,Anfield
2723,1973-01-06,1972.0,West Ham United,Liverpool,0-1,0,1,1,1,1,-1,A,"Shankly, Bill",1,Away
2724,1973-01-20,1972.0,Liverpool,Derby County,1-1,1,1,1,1,2,0,D,"Shankly, Bill",1,Anfield
2725,1973-01-27,1972.0,Wolverhampton Wanderers,Liverpool,2-1,2,1,1,1,3,1,H,"Shankly, Bill",1,Away
2726,1973-02-10,1972.0,Liverpool,Arsenal,0-2,0,2,1,1,2,-2,A,"Shankly, Bill",0,Anfield
2727,1973-02-17,1972.0,Manchester City,Liverpool,1-1,1,1,1,1,2,0,D,"Shankly, Bill",1,Away
2728,1973-02-24,1972.0,Liverpool,Ipswich Town,2-1,2,1,1,1,3,1,H,"Shankly, Bill",2,Anfield
2729,1973-03-03,1972.0,Everton,Liverpool,0-2,0,2,1,1,2,-2,A,"Shankly, Bill",2,Away
2730,1973-03-10,1972.0,Liverpool,Southampton,3-2,3,2,1,1,5,1,H,"Shankly, Bill",3,Anfield
2731,1973-03-17,1972.0,Stoke City,Liverpool,0-1,0,1,1,1,1,-1,A,"Shankly, Bill",1,Away
2732,1973-03-24,1972.0,Liverpool,Norwich City,3-1,3,1,1,1,4,2,H,"Shankly, Bill",3,Anfield
2733,1973-03-31,1972.0,Liverpool,Tottenham Hotspur,1-1,1,1,1,1,2,0,D,"Shankly, Bill",1,Anfield
2734,1973-04-07,1972.0,Birmingham City,Liverpool,2-1,2,1,1,1,3,1,H,"Shankly, Bill",1,Away
2735,1973-04-14,1972.0,Liverpool,West Bromwich Albion,1-0,1,0,1,1,1,1,H,"Shankly, Bill",1,Anfield
2736,1973-04-17,1972.0,Coventry City,Liverpool,1-2,1,2,1,1,3,-1,A,"Shankly, Bill",2,Away
2737,1973-04-21,1972.0,Newcastle United,Liverpool,2-1,2,1,1,1,3,1,H,"Shankly, Bill",1,Away
2738,1973-04-23,1972.0,Liverpool,Leeds United,2-0,2,0,1,1,2,2,H,"Shankly, Bill",2,Anfield
2739,1973-04-28,1972.0,Liverpool,Leicester City,0-0,0,0,1,1,0,0,D,"Shankly, Bill",0,Anfield
2740,1973-08-25,1973.0,Liverpool,Stoke City,1-0,1,0,1,1,1,1,H,"Shankly, Bill",1,Anfield
2741,1973-08-28,1973.0,Coventry City,Liverpool,1-0,1,0,1,1,1,1,H,"Shankly, Bill",0,Away
2742,1973-09-01,1973.0,Leicester City,Liverpool,1-1,1,1,1,1,2,0,D,"Shankly, Bill",1,Away
2743,1973-09-04,1973.0,Liverpool,Derby County,2-0,2,0,1,1,2,2,H,"Shankly, Bill",2,Anfield
2744,1973-09-08,1973.0,Liverpool,Chelsea,1-0,1,0,1,1,1,1,H,"Shankly, Bill",1,Anfield
2745,1973-09-12,1973.0,Derby County,Liverpool,3-1,3,1,1,1,4,2,H,"Shankly, Bill",1,Away
2746,1973-09-15,1973.0,Birmingham City,Liverpool,1-1,1,1,1,1,2,0,D,"Shankly, Bill",1,Away
2747,1973-09-22,1973.0,Liverpool,Tottenham Hotspur,3-2,3,2,1,1,5,1,H,"Shankly, Bill",3,Anfield
2748,1973-09-29,1973.0,Manchester United,Liverpool,0-0,0,0,1,1,0,0,D,"Shankly, Bill",0,Away
2749,1973-10-06,1973.0,Liverpool,Newcastle United,2-1,2,1,1,1,3,1,H,"Shankly, Bill",2,Anfield
2750,1973-10-13,1973.0,Southampton,Liverpool,1-0,1,0,1,1,1,1,H,"Shankly, Bill",0,Away
2751,1973-10-20,1973.0,Leeds United,Liverpool,1-0,1,0,1,1,1,1,H,"Shankly, Bill",0,Away
2752,1973-10-27,1973.0,Liverpool,Sheffield United,1-0,1,0,1,1,1,1,H,"Shankly, Bill",1,Anfield
2753,1973-11-03,1973.0,Arsenal,Liverpool,0-2,0,2,1,1,2,-2,A,"Shankly, Bill",2,Away
2754,1973-11-10,1973.0,Liverpool,Wolverhampton Wanderers,1-0,1,0,1,1,1,1,H,"Shankly, Bill",1,Anfield
2755,1973-11-17,1973.0,Liverpool,Ipswich Town,4-2,4,2,1,1,6,2,H,"Shankly, Bill",4,Anfield
2756,1973-11-24,1973.0,Queens Park Rangers,Liverpool,2-2,2,2,1,1,4,0,D,"Shankly, Bill",2,Away
2757,1973-12-01,1973.0,Liverpool,West Ham United,1-0,1,0,1,1,1,1,H,"Shankly, Bill",1,Anfield
2758,1973-12-08,1973.0,Everton,Liverpool,0-1,0,1,1,1,1,-1,A,"Shankly, Bill",1,Away
2759,1973-12-15,1973.0,Norwich City,Liverpool,1-1,1,1,1,1,2,0,D,"Shankly, Bill",1,Away
2760,1973-12-22,1973.0,Liverpool,Manchester United,2-0,2,0,1,1,2,2,H,"Shankly, Bill",2,Anfield
2761,1973-12-26,1973.0,Burnley,Liverpool,2-1,2,1,1,1,3,1,H,"Shankly, Bill",1,Away
2762,1973-12-29,1973.0,Chelsea,Liverpool,0-1,0,1,1,1,1,-1,A,"Shankly, Bill",1,Away
2763,1974-01-01,1973.0,Liverpool,Leicester City,1-1,1,1,1,1,2,0,D,"Shankly, Bill",1,Anfield
2764,1974-01-12,1973.0,Liverpool,Birmingham City,3-2,3,2,1,1,5,1,H,"Shankly, Bill",3,Anfield
2765,1974-01-19,1973.0,Stoke City,Liverpool,1-1,1,1,1,1,2,0,D,"Shankly, Bill",1,Away
2766,1974-02-02,1973.0,Liverpool,Norwich City,1-0,1,0,1,1,1,1,H,"Shankly, Bill",1,Anfield
2767,1974-02-05,1973.0,Liverpool,Coventry City,2-1,2,1,1,1,3,1,H,"Shankly, Bill",2,Anfield
2768,1974-02-23,1973.0,Newcastle United,Liverpool,0-0,0,0,1,1,0,0,D,"Shankly, Bill",0,Away
2769,1974-02-26,1973.0,Liverpool,Southampton,1-0,1,0,1,1,1,1,H,"Shankly, Bill",1,Anfield
2770,1974-03-02,1973.0,Liverpool,Burnley,1-0,1,0,1,1,1,1,H,"Shankly, Bill",1,Anfield
2771,1974-03-16,1973.0,Liverpool,Leeds United,1-0,1,0,1,1,1,1,H,"Shankly, Bill",1,Anfield
2772,1974-03-23,1973.0,Wolverhampton Wanderers,Liverpool,0-1,0,1,1,1,1,-1,A,"Shankly, Bill",1,Away
2773,1974-04-06,1973.0,Liverpool,Queens Park Rangers,2-1,2,1,1,1,3,1,H,"Shankly, Bill",2,Anfield
2774,1974-04-08,1973.0,Sheffield United,Liverpool,1-0,1,0,1,1,1,1,H,"Shankly, Bill",0,Away
2775,1974-04-12,1973.0,Manchester City,Liverpool,1-1,1,1,1,1,2,0,D,"Shankly, Bill",1,Away
2776,1974-04-13,1973.0,Ipswich Town,Liverpool,1-1,1,1,1,1,2,0,D,"Shankly, Bill",1,Away
2777,1974-04-16,1973.0,Liverpool,Manchester City,4-0,4,0,1,1,4,4,H,"Shankly, Bill",4,Anfield
2778,1974-04-20,1973.0,Liverpool,Everton,0-0,0,0,1,1,0,0,D,"Shankly, Bill",0,Anfield
2779,1974-04-24,1973.0,Liverpool,Arsenal,0-1,0,1,1,1,1,-1,A,"Shankly, Bill",0,Anfield
2780,1974-04-27,1973.0,West Ham United,Liverpool,2-2,2,2,1,1,4,0,D,"Shankly, Bill",2,Away
2781,1974-05-08,1973.0,Tottenham Hotspur,Liverpool,1-1,1,1,1,1,2,0,D,"Shankly, Bill",1,Away
2782,1974-08-17,1974.0,Luton Town,Liverpool,1-2,1,2,1,1,3,-1,A,character(0),2,Away
2783,1974-08-20,1974.0,Wolverhampton Wanderers,Liverpool,0-0,0,0,1,1,0,0,D,character(0),0,Away
2784,1974-08-24,1974.0,Liverpool,Leicester City,2-1,2,1,1,1,3,1,H,character(0),2,Anfield
2785,1974-08-27,1974.0,Liverpool,Wolverhampton Wanderers,2-0,2,0,1,1,2,2,H,"Paisley, Bob",2,Anfield
2786,1974-08-31,1974.0,Chelsea,Liverpool,0-3,0,3,1,1,3,-3,A,"Paisley, Bob",3,Away
2787,1974-09-07,1974.0,Liverpool,Tottenham Hotspur,5-2,5,2,1,1,7,3,H,"Paisley, Bob",5,Anfield
2788,1974-09-14,1974.0,Manchester City,Liverpool,2-0,2,0,1,1,2,2,H,"Paisley, Bob",0,Away
2789,1974-09-21,1974.0,Liverpool,Stoke City,3-0,3,0,1,1,3,3,H,"Paisley, Bob",3,Anfield
2790,1974-09-24,1974.0,Liverpool,Burnley,0-1,0,1,1,1,1,-1,A,"Paisley, Bob",0,Anfield
2791,1974-09-28,1974.0,Sheffield United,Liverpool,1-0,1,0,1,1,1,1,H,"Paisley, Bob",0,Away
2792,1974-10-05,1974.0,Carlisle United,Liverpool,0-1,0,1,1,1,1,-1,A,"Paisley, Bob",1,Away
2793,1974-10-12,1974.0,Liverpool,Middlesbrough,2-0,2,0,1,1,2,2,H,"Paisley, Bob",2,Anfield
2794,1974-10-19,1974.0,Queens Park Rangers,Liverpool,0-1,0,1,1,1,1,-1,A,"Paisley, Bob",1,Away
2795,1974-10-26,1974.0,Liverpool,Leeds United,1-0,1,0,1,1,1,1,H,"Paisley, Bob",1,Anfield
2796,1974-11-02,1974.0,Ipswich Town,Liverpool,1-0,1,0,1,1,1,1,H,"Paisley, Bob",0,Away
2797,1974-11-09,1974.0,Liverpool,Arsenal,1-3,1,3,1,1,4,-2,A,"Paisley, Bob",1,Anfield
2798,1974-11-16,1974.0,Everton,Liverpool,0-0,0,0,1,1,0,0,D,"Paisley, Bob",0,Away
2799,1974-11-23,1974.0,Liverpool,West Ham United,1-1,1,1,1,1,2,0,D,"Paisley, Bob",1,Anfield
2800,1974-11-30,1974.0,Coventry City,Liverpool,1-1,1,1,1,1,2,0,D,"Paisley, Bob",1,Away
2801,1974-12-07,1974.0,Liverpool,Derby County,2-2,2,2,1,1,4,0,D,"Paisley, Bob",2,Anfield
2802,1974-12-14,1974.0,Liverpool,Luton Town,2-0,2,0,1,1,2,2,H,"Paisley, Bob",2,Anfield
2803,1974-12-21,1974.0,Birmingham City,Liverpool,3-1,3,1,1,1,4,2,H,"Paisley, Bob",1,Away
2804,1974-12-26,1974.0,Liverpool,Manchester City,4-1,4,1,1,1,5,3,H,"Paisley, Bob",4,Anfield
2805,1975-01-11,1974.0,Derby County,Liverpool,2-0,2,0,1,1,2,2,H,"Paisley, Bob",0,Away
2806,1975-01-18,1974.0,Liverpool,Coventry City,2-1,2,1,1,1,3,1,H,"Paisley, Bob",2,Anfield
2807,1975-02-01,1974.0,Arsenal,Liverpool,2-0,2,0,1,1,2,2,H,"Paisley, Bob",0,Away
2808,1975-02-08,1974.0,Liverpool,Ipswich Town,5-2,5,2,1,1,7,3,H,"Paisley, Bob",5,Anfield
2809,1975-02-12,1974.0,Newcastle United,Liverpool,4-1,4,1,1,1,5,3,H,"Paisley, Bob",1,Away
2810,1975-02-19,1974.0,West Ham United,Liverpool,0-0,0,0,1,1,0,0,D,"Paisley, Bob",0,Away
2811,1975-02-22,1974.0,Liverpool,Everton,0-0,0,0,1,1,0,0,D,"Paisley, Bob",0,Anfield
2812,1975-03-01,1974.0,Liverpool,Chelsea,2-2,2,2,1,1,4,0,D,"Paisley, Bob",2,Anfield
2813,1975-03-08,1974.0,Burnley,Liverpool,1-1,1,1,1,1,2,0,D,"Paisley, Bob",1,Away
2814,1975-03-15,1974.0,Liverpool,Sheffield United,0-0,0,0,1,1,0,0,D,"Paisley, Bob",0,Anfield
2815,1975-03-19,1974.0,Leicester City,Liverpool,1-1,1,1,1,1,2,0,D,"Paisley, Bob",1,Away
2816,1975-03-22,1974.0,Tottenham Hotspur,Liverpool,0-2,0,2,1,1,2,-2,A,"Paisley, Bob",2,Away
2817,1975-03-25,1974.0,Liverpool,Newcastle United,4-0,4,0,1,1,4,4,H,"Paisley, Bob",4,Anfield
2818,1975-03-29,1974.0,Liverpool,Birmingham City,1-0,1,0,1,1,1,1,H,"Paisley, Bob",1,Anfield
2819,1975-03-31,1974.0,Stoke City,Liverpool,2-0,2,0,1,1,2,2,H,"Paisley, Bob",0,Away
2820,1975-04-05,1974.0,Leeds United,Liverpool,0-2,0,2,1,1,2,-2,A,"Paisley, Bob",2,Away
2821,1975-04-12,1974.0,Liverpool,Carlisle United,2-0,2,0,1,1,2,2,H,"Paisley, Bob",2,Anfield
2822,1975-04-19,1974.0,Middlesbrough,Liverpool,1-0,1,0,1,1,1,1,H,"Paisley, Bob",0,Away
2823,1975-04-26,1974.0,Liverpool,Queens Park Rangers,3-1,3,1,1,1,4,2,H,"Paisley, Bob",3,Anfield
2824,1975-08-16,1975.0,Queens Park Rangers,Liverpool,2-0,2,0,1,1,2,2,H,"Paisley, Bob",0,Away
2825,1975-08-19,1975.0,Liverpool,West Ham United,2-2,2,2,1,1,4,0,D,"Paisley, Bob",2,Anfield
2826,1975-08-23,1975.0,Liverpool,Tottenham Hotspur,3-2,3,2,1,1,5,1,H,"Paisley, Bob",3,Anfield
2827,1975-08-26,1975.0,Leeds United,Liverpool,0-3,0,3,1,1,3,-3,A,"Paisley, Bob",3,Away
2828,1975-08-30,1975.0,Leicester City,Liverpool,1-1,1,1,1,1,2,0,D,"Paisley, Bob",1,Away
2829,1975-09-06,1975.0,Liverpool,Sheffield United,1-0,1,0,1,1,1,1,H,"Paisley, Bob",1,Anfield
2830,1975-09-13,1975.0,Ipswich Town,Liverpool,2-0,2,0,1,1,2,2,H,"Paisley, Bob",0,Away
2831,1975-09-20,1975.0,Liverpool,Aston Villa,3-0,3,0,1,1,3,3,H,"Paisley, Bob",3,Anfield
2832,1975-09-27,1975.0,Everton,Liverpool,0-0,0,0,1,1,0,0,D,"Paisley, Bob",0,Away
2833,1975-10-04,1975.0,Liverpool,Wolverhampton Wanderers,2-0,2,0,1,1,2,2,H,"Paisley, Bob",2,Anfield
2834,1975-10-11,1975.0,Liverpool,Birmingham City,3-1,3,1,1,1,4,2,H,"Paisley, Bob",3,Anfield
2835,1975-10-18,1975.0,Coventry City,Liverpool,0-0,0,0,1,1,0,0,D,"Paisley, Bob",0,Away
2836,1975-10-25,1975.0,Liverpool,Derby County,1-1,1,1,1,1,2,0,D,"Paisley, Bob",1,Anfield
2837,1975-11-01,1975.0,Middlesbrough,Liverpool,0-1,0,1,1,1,1,-1,A,"Paisley, Bob",1,Away
2838,1975-11-08,1975.0,Liverpool,Manchester United,3-1,3,1,1,1,4,2,H,"Paisley, Bob",3,Anfield
2839,1975-11-15,1975.0,Newcastle United,Liverpool,1-2,1,2,1,1,3,-1,A,"Paisley, Bob",2,Away
2840,1975-11-22,1975.0,Liverpool,Coventry City,1-1,1,1,1,1,2,0,D,"Paisley, Bob",1,Anfield
2841,1975-11-29,1975.0,Liverpool,Norwich City,1-3,1,3,1,1,4,-2,A,"Paisley, Bob",1,Anfield
2842,1975-12-02,1975.0,Liverpool,Arsenal,2-2,2,2,1,1,4,0,D,"Paisley, Bob",2,Anfield
2843,1975-12-06,1975.0,Burnley,Liverpool,0-0,0,0,1,1,0,0,D,"Paisley, Bob",0,Away
2844,1975-12-13,1975.0,Tottenham Hotspur,Liverpool,0-4,0,4,1,1,4,-4,A,"Paisley, Bob",4,Away
2845,1975-12-20,1975.0,Liverpool,Queens Park Rangers,2-0,2,0,1,1,2,2,H,"Paisley, Bob",2,Anfield
2846,1975-12-26,1975.0,Stoke City,Liverpool,1-1,1,1,1,1,2,0,D,"Paisley, Bob",1,Away
2847,1975-12-27,1975.0,Liverpool,Manchester City,1-0,1,0,1,1,1,1,H,"Paisley, Bob",1,Anfield
2848,1976-01-10,1975.0,Liverpool,Ipswich Town,3-3,3,3,1,1,6,0,D,"Paisley, Bob",3,Anfield
2849,1976-01-17,1975.0,Sheffield United,Liverpool,0-0,0,0,1,1,0,0,D,"Paisley, Bob",0,Away
2850,1976-01-31,1975.0,West Ham United,Liverpool,0-4,0,4,1,1,4,-4,A,"Paisley, Bob",4,Away
2851,1976-02-07,1975.0,Liverpool,Leeds United,2-0,2,0,1,1,2,2,H,"Paisley, Bob",2,Anfield
2852,1976-02-18,1975.0,Manchester United,Liverpool,0-0,0,0,1,1,0,0,D,"Paisley, Bob",0,Away
2853,1976-02-21,1975.0,Liverpool,Newcastle United,2-0,2,0,1,1,2,2,H,"Paisley, Bob",2,Anfield
2854,1976-02-24,1975.0,Arsenal,Liverpool,1-0,1,0,1,1,1,1,H,"Paisley, Bob",0,Away
2855,1976-02-28,1975.0,Derby County,Liverpool,1-1,1,1,1,1,2,0,D,"Paisley, Bob",1,Away
2856,1976-03-06,1975.0,Liverpool,Middlesbrough,0-2,0,2,1,1,2,-2,A,"Paisley, Bob",0,Anfield
2857,1976-03-13,1975.0,Birmingham City,Liverpool,0-1,0,1,1,1,1,-1,A,"Paisley, Bob",1,Away
2858,1976-03-20,1975.0,Norwich City,Liverpool,0-1,0,1,1,1,1,-1,A,"Paisley, Bob",1,Away
2859,1976-03-27,1975.0,Liverpool,Burnley,2-0,2,0,1,1,2,2,H,"Paisley, Bob",2,Anfield
2860,1976-04-03,1975.0,Liverpool,Everton,1-0,1,0,1,1,1,1,H,"Paisley, Bob",1,Anfield
2861,1976-04-06,1975.0,Liverpool,Leicester City,1-0,1,0,1,1,1,1,H,"Paisley, Bob",1,Anfield
2862,1976-04-10,1975.0,Aston Villa,Liverpool,0-0,0,0,1,1,0,0,D,"Paisley, Bob",0,Away
2863,1976-04-17,1975.0,Liverpool,Stoke City,5-3,5,3,1,1,8,2,H,"Paisley, Bob",5,Anfield
2864,1976-04-19,1975.0,Manchester City,Liverpool,0-3,0,3,1,1,3,-3,A,"Paisley, Bob",3,Away
2865,1976-05-04,1975.0,Wolverhampton Wanderers,Liverpool,1-3,1,3,1,1,4,-2,A,"Paisley, Bob",3,Away
2866,1976-08-21,1976.0,Liverpool,Norwich City,1-0,1,0,1,1,1,1,H,"Paisley, Bob",1,Anfield
2867,1976-08-25,1976.0,West Bromwich Albion,Liverpool,0-1,0,1,1,1,1,-1,A,"Paisley, Bob",1,Away
2868,1976-08-28,1976.0,Birmingham City,Liverpool,2-1,2,1,1,1,3,1,H,"Paisley, Bob",1,Away
2869,1976-09-04,1976.0,Liverpool,Coventry City,3-1,3,1,1,1,4,2,H,"Paisley, Bob",3,Anfield
2870,1976-09-11,1976.0,Derby County,Liverpool,2-3,2,3,1,1,5,-1,A,"Paisley, Bob",3,Away
2871,1976-09-18,1976.0,Liverpool,Tottenham Hotspur,2-0,2,0,1,1,2,2,H,"Paisley, Bob",2,Anfield
2872,1976-09-25,1976.0,Newcastle United,Liverpool,1-0,1,0,1,1,1,1,H,"Paisley, Bob",0,Away
2873,1976-10-02,1976.0,Liverpool,Middlesbrough,0-0,0,0,1,1,0,0,D,"Paisley, Bob",0,Anfield
2874,1976-10-16,1976.0,Liverpool,Everton,3-1,3,1,1,1,4,2,H,"Paisley, Bob",3,Anfield
2875,1976-10-23,1976.0,Leeds United,Liverpool,1-1,1,1,1,1,2,0,D,"Paisley, Bob",1,Away
2876,1976-10-27,1976.0,Leicester City,Liverpool,0-1,0,1,1,1,1,-1,A,"Paisley, Bob",1,Away
2877,1976-10-30,1976.0,Liverpool,Aston Villa,3-0,3,0,1,1,3,3,H,"Paisley, Bob",3,Anfield
2878,1976-11-06,1976.0,Sunderland,Liverpool,0-1,0,1,1,1,1,-1,A,"Paisley, Bob",1,Away
2879,1976-11-09,1976.0,Liverpool,Leicester City,5-1,5,1,1,1,6,4,H,"Paisley, Bob",5,Anfield
2880,1976-11-20,1976.0,Arsenal,Liverpool,1-1,1,1,1,1,2,0,D,"Paisley, Bob",1,Away
2881,1976-11-27,1976.0,Liverpool,Bristol City,2-1,2,1,1,1,3,1,H,"Paisley, Bob",2,Anfield
2882,1976-12-04,1976.0,Ipswich Town,Liverpool,1-0,1,0,1,1,1,1,H,"Paisley, Bob",0,Away
2883,1976-12-11,1976.0,Liverpool,Queens Park Rangers,3-1,3,1,1,1,4,2,H,"Paisley, Bob",3,Anfield
2884,1976-12-15,1976.0,Aston Villa,Liverpool,5-1,5,1,1,1,6,4,H,"Paisley, Bob",1,Away
2885,1976-12-18,1976.0,West Ham United,Liverpool,2-0,2,0,1,1,2,2,H,"Paisley, Bob",0,Away
2886,1976-12-27,1976.0,Liverpool,Stoke City,4-0,4,0,1,1,4,4,H,"Paisley, Bob",4,Anfield
2887,1976-12-29,1976.0,Manchester City,Liverpool,1-1,1,1,1,1,2,0,D,"Paisley, Bob",1,Away
2888,1977-01-01,1976.0,Liverpool,Sunderland,2-0,2,0,1,1,2,2,H,"Paisley, Bob",2,Anfield
2889,1977-01-15,1976.0,Liverpool,West Bromwich Albion,1-1,1,1,1,1,2,0,D,"Paisley, Bob",1,Anfield
2890,1977-01-22,1976.0,Norwich City,Liverpool,2-1,2,1,1,1,3,1,H,"Paisley, Bob",1,Away
2891,1977-02-05,1976.0,Liverpool,Birmingham City,4-1,4,1,1,1,5,3,H,"Paisley, Bob",4,Anfield
2892,1977-02-16,1976.0,Manchester United,Liverpool,0-0,0,0,1,1,0,0,D,"Paisley, Bob",0,Away
2893,1977-02-19,1976.0,Liverpool,Derby County,3-1,3,1,1,1,4,2,H,"Paisley, Bob",3,Anfield
2894,1977-03-05,1976.0,Liverpool,Newcastle United,1-0,1,0,1,1,1,1,H,"Paisley, Bob",1,Anfield
2895,1977-03-09,1976.0,Tottenham Hotspur,Liverpool,1-0,1,0,1,1,1,1,H,"Paisley, Bob",0,Away
2896,1977-03-12,1976.0,Middlesbrough,Liverpool,0-1,0,1,1,1,1,-1,A,"Paisley, Bob",1,Away
2897,1977-03-22,1976.0,Everton,Liverpool,0-0,0,0,1,1,0,0,D,"Paisley, Bob",0,Away
2898,1977-04-02,1976.0,Liverpool,Leeds United,3-1,3,1,1,1,4,2,H,"Paisley, Bob",3,Anfield
2899,1977-04-09,1976.0,Liverpool,Manchester City,2-1,2,1,1,1,3,1,H,"Paisley, Bob",2,Anfield
2900,1977-04-11,1976.0,Stoke City,Liverpool,0-0,0,0,1,1,0,0,D,"Paisley, Bob",0,Away
2901,1977-04-16,1976.0,Liverpool,Arsenal,2-0,2,0,1,1,2,2,H,"Paisley, Bob",2,Anfield
2902,1977-04-30,1976.0,Liverpool,Ipswich Town,2-1,2,1,1,1,3,1,H,"Paisley, Bob",2,Anfield
2903,1977-05-03,1976.0,Liverpool,Manchester United,1-0,1,0,1,1,1,1,H,"Paisley, Bob",1,Anfield
2904,1977-05-07,1976.0,Queens Park Rangers,Liverpool,1-1,1,1,1,1,2,0,D,"Paisley, Bob",1,Away
2905,1977-05-10,1976.0,Coventry City,Liverpool,0-0,0,0,1,1,0,0,D,"Paisley, Bob",0,Away
2906,1977-05-14,1976.0,Liverpool,West Ham United,0-0,0,0,1,1,0,0,D,"Paisley, Bob",0,Anfield
2907,1977-05-16,1976.0,Bristol City,Liverpool,2-1,2,1,1,1,3,1,H,"Paisley, Bob",1,Away
2908,1977-08-20,1977.0,Middlesbrough,Liverpool,1-1,1,1,1,1,2,0,D,"Paisley, Bob",1,Away
2909,1977-08-23,1977.0,Liverpool,Newcastle United,2-0,2,0,1,1,2,2,H,"Paisley, Bob",2,Anfield
2910,1977-08-27,1977.0,Liverpool,West Bromwich Albion,3-0,3,0,1,1,3,3,H,"Paisley, Bob",3,Anfield
2911,1977-09-03,1977.0,Birmingham City,Liverpool,0-1,0,1,1,1,1,-1,A,"Paisley, Bob",1,Away
2912,1977-09-10,1977.0,Liverpool,Coventry City,2-0,2,0,1,1,2,2,H,"Paisley, Bob",2,Anfield
2913,1977-09-17,1977.0,Ipswich Town,Liverpool,1-1,1,1,1,1,2,0,D,"Paisley, Bob",1,Away
2914,1977-09-24,1977.0,Liverpool,Derby County,1-0,1,0,1,1,1,1,H,"Paisley, Bob",1,Anfield
2915,1977-10-01,1977.0,Manchester United,Liverpool,2-0,2,0,1,1,2,2,H,"Paisley, Bob",0,Away
2916,1977-10-04,1977.0,Arsenal,Liverpool,0-0,0,0,1,1,0,0,D,"Paisley, Bob",0,Away
2917,1977-10-08,1977.0,Liverpool,Chelsea,2-0,2,0,1,1,2,2,H,"Paisley, Bob",2,Anfield
2918,1977-10-15,1977.0,Leeds United,Liverpool,1-2,1,2,1,1,3,-1,A,"Paisley, Bob",2,Away
2919,1977-10-22,1977.0,Liverpool,Everton,0-0,0,0,1,1,0,0,D,"Paisley, Bob",0,Anfield
2920,1977-10-29,1977.0,Manchester City,Liverpool,3-1,3,1,1,1,4,2,H,"Paisley, Bob",1,Away
2921,1977-11-05,1977.0,Liverpool,Aston Villa,1-2,1,2,1,1,3,-1,A,"Paisley, Bob",1,Anfield
2922,1977-11-12,1977.0,Queens Park Rangers,Liverpool,2-0,2,0,1,1,2,2,H,"Paisley, Bob",0,Away
2923,1977-11-19,1977.0,Liverpool,Bristol City,1-1,1,1,1,1,2,0,D,"Paisley, Bob",1,Anfield
2924,1977-11-26,1977.0,Leicester City,Liverpool,0-4,0,4,1,1,4,-4,A,"Paisley, Bob",4,Away
2925,1977-12-03,1977.0,Liverpool,West Ham United,2-0,2,0,1,1,2,2,H,"Paisley, Bob",2,Anfield
2926,1977-12-10,1977.0,Norwich City,Liverpool,2-1,2,1,1,1,3,1,H,"Paisley, Bob",1,Away
2927,1977-12-17,1977.0,Liverpool,Queens Park Rangers,1-0,1,0,1,1,1,1,H,"Paisley, Bob",1,Anfield
2928,1977-12-26,1977.0,Nottingham Forest,Liverpool,1-1,1,1,1,1,2,0,D,"Paisley, Bob",1,Away
2929,1977-12-27,1977.0,Liverpool,Wolverhampton Wanderers,1-0,1,0,1,1,1,1,H,"Paisley, Bob",1,Anfield
2930,1977-12-31,1977.0,Newcastle United,Liverpool,0-2,0,2,1,1,2,-2,A,"Paisley, Bob",2,Away
2931,1978-01-02,1977.0,Liverpool,Middlesbrough,2-0,2,0,1,1,2,2,H,"Paisley, Bob",2,Anfield
2932,1978-01-14,1977.0,West Bromwich Albion,Liverpool,0-1,0,1,1,1,1,-1,A,"Paisley, Bob",1,Away
2933,1978-01-21,1977.0,Liverpool,Birmingham City,2-3,2,3,1,1,5,-1,A,"Paisley, Bob",2,Anfield
2934,1978-02-04,1977.0,Coventry City,Liverpool,1-0,1,0,1,1,1,1,H,"Paisley, Bob",0,Away
2935,1978-02-25,1977.0,Liverpool,Manchester United,3-1,3,1,1,1,4,2,H,"Paisley, Bob",3,Anfield
2936,1978-03-04,1977.0,Chelsea,Liverpool,3-1,3,1,1,1,4,2,H,"Paisley, Bob",1,Away
2937,1978-03-08,1977.0,Derby County,Liverpool,4-2,4,2,1,1,6,2,H,"Paisley, Bob",2,Away
2938,1978-03-11,1977.0,Liverpool,Leeds United,1-0,1,0,1,1,1,1,H,"Paisley, Bob",1,Anfield
2939,1978-03-25,1977.0,Wolverhampton Wanderers,Liverpool,1-3,1,3,1,1,4,-2,A,"Paisley, Bob",3,Away
2940,1978-04-01,1977.0,Aston Villa,Liverpool,0-3,0,3,1,1,3,-3,A,"Paisley, Bob",3,Away
2941,1978-04-05,1977.0,Everton,Liverpool,0-1,0,1,1,1,1,-1,A,"Paisley, Bob",1,Away
2942,1978-04-08,1977.0,Liverpool,Leicester City,3-2,3,2,1,1,5,1,H,"Paisley, Bob",3,Anfield
2943,1978-04-15,1977.0,Bristol City,Liverpool,1-1,1,1,1,1,2,0,D,"Paisley, Bob",1,Away
2944,1978-04-18,1977.0,Liverpool,Ipswich Town,2-2,2,2,1,1,4,0,D,"Paisley, Bob",2,Anfield
2945,1978-04-22,1977.0,Liverpool,Norwich City,3-0,3,0,1,1,3,3,H,"Paisley, Bob",3,Anfield
2946,1978-04-25,1977.0,Liverpool,Arsenal,1-0,1,0,1,1,1,1,H,"Paisley, Bob",1,Anfield
2947,1978-04-29,1977.0,West Ham United,Liverpool,0-2,0,2,1,1,2,-2,A,"Paisley, Bob",2,Away
2948,1978-05-01,1977.0,Liverpool,Manchester City,4-0,4,0,1,1,4,4,H,"Paisley, Bob",4,Anfield
2949,1978-05-04,1977.0,Liverpool,Nottingham Forest,0-0,0,0,1,1,0,0,D,"Paisley, Bob",0,Anfield
2950,1978-08-19,1978.0,Liverpool,Queens Park Rangers,2-1,2,1,1,1,3,1,H,"Paisley, Bob",2,Anfield
2951,1978-08-22,1978.0,Ipswich Town,Liverpool,0-3,0,3,1,1,3,-3,A,"Paisley, Bob",3,Away
2952,1978-08-26,1978.0,Manchester City,Liverpool,1-4,1,4,1,1,5,-3,A,"Paisley, Bob",4,Away
2953,1978-09-02,1978.0,Liverpool,Tottenham Hotspur,7-0,7,0,1,1,7,7,H,"Paisley, Bob",7,Anfield
2954,1978-09-09,1978.0,Birmingham City,Liverpool,0-3,0,3,1,1,3,-3,A,"Paisley, Bob",3,Away
2955,1978-09-16,1978.0,Liverpool,Coventry City,1-0,1,0,1,1,1,1,H,"Paisley, Bob",1,Anfield
2956,1978-09-23,1978.0,West Bromwich Albion,Liverpool,1-1,1,1,1,1,2,0,D,"Paisley, Bob",1,Away
2957,1978-09-30,1978.0,Liverpool,Bolton Wanderers,3-0,3,0,1,1,3,3,H,"Paisley, Bob",3,Anfield
2958,1978-10-07,1978.0,Norwich City,Liverpool,1-4,1,4,1,1,5,-3,A,"Paisley, Bob",4,Away
2959,1978-10-14,1978.0,Liverpool,Derby County,5-0,5,0,1,1,5,5,H,"Paisley, Bob",5,Anfield
2960,1978-10-21,1978.0,Liverpool,Chelsea,2-0,2,0,1,1,2,2,H,"Paisley, Bob",2,Anfield
2961,1978-10-28,1978.0,Everton,Liverpool,1-0,1,0,1,1,1,1,H,"Paisley, Bob",0,Away
2962,1978-11-04,1978.0,Liverpool,Leeds United,1-1,1,1,1,1,2,0,D,"Paisley, Bob",1,Anfield
2963,1978-11-11,1978.0,Queens Park Rangers,Liverpool,1-3,1,3,1,1,4,-2,A,"Paisley, Bob",3,Away
2964,1978-11-18,1978.0,Liverpool,Manchester City,1-0,1,0,1,1,1,1,H,"Paisley, Bob",1,Anfield
2965,1978-11-22,1978.0,Tottenham Hotspur,Liverpool,0-0,0,0,1,1,0,0,D,"Paisley, Bob",0,Away
2966,1978-11-25,1978.0,Liverpool,Middlesbrough,2-0,2,0,1,1,2,2,H,"Paisley, Bob",2,Anfield
2967,1978-12-02,1978.0,Arsenal,Liverpool,1-0,1,0,1,1,1,1,H,"Paisley, Bob",0,Away
2968,1978-12-09,1978.0,Liverpool,Nottingham Forest,2-0,2,0,1,1,2,2,H,"Paisley, Bob",2,Anfield
2969,1978-12-16,1978.0,Bristol City,Liverpool,1-0,1,0,1,1,1,1,H,"Paisley, Bob",0,Away
2970,1978-12-26,1978.0,Manchester United,Liverpool,0-3,0,3,1,1,3,-3,A,"Paisley, Bob",3,Away
2971,1979-02-03,1978.0,Liverpool,West Bromwich Albion,2-1,2,1,1,1,3,1,H,"Paisley, Bob",2,Anfield
2972,1979-02-13,1978.0,Liverpool,Birmingham City,1-0,1,0,1,1,1,1,H,"Paisley, Bob",1,Anfield
2973,1979-02-21,1978.0,Liverpool,Norwich City,6-0,6,0,1,1,6,6,H,"Paisley, Bob",6,Anfield
2974,1979-02-24,1978.0,Derby County,Liverpool,0-2,0,2,1,1,2,-2,A,"Paisley, Bob",2,Away
2975,1979-03-03,1978.0,Chelsea,Liverpool,0-0,0,0,1,1,0,0,D,"Paisley, Bob",0,Away
2976,1979-03-06,1978.0,Coventry City,Liverpool,0-0,0,0,1,1,0,0,D,"Paisley, Bob",0,Away
2977,1979-03-13,1978.0,Liverpool,Everton,1-1,1,1,1,1,2,0,D,"Paisley, Bob",1,Anfield
2978,1979-03-20,1978.0,Liverpool,Wolverhampton Wanderers,2-0,2,0,1,1,2,2,H,"Paisley, Bob",2,Anfield
2979,1979-03-24,1978.0,Liverpool,Ipswich Town,2-0,2,0,1,1,2,2,H,"Paisley, Bob",2,Anfield
2980,1979-04-07,1978.0,Liverpool,Arsenal,3-0,3,0,1,1,3,3,H,"Paisley, Bob",3,Anfield
2981,1979-04-10,1978.0,Wolverhampton Wanderers,Liverpool,0-1,0,1,1,1,1,-1,A,"Paisley, Bob",1,Away
2982,1979-04-14,1978.0,Liverpool,Manchester United,2-0,2,0,1,1,2,2,H,"Paisley, Bob",2,Anfield
2983,1979-04-16,1978.0,Aston Villa,Liverpool,3-1,3,1,1,1,4,2,H,"Paisley, Bob",1,Away
2984,1979-04-21,1978.0,Liverpool,Bristol City,1-0,1,0,1,1,1,1,H,"Paisley, Bob",1,Anfield
2985,1979-04-24,1978.0,Southampton,Liverpool,1-1,1,1,1,1,2,0,D,"Paisley, Bob",1,Away
2986,1979-04-28,1978.0,Nottingham Forest,Liverpool,0-0,0,0,1,1,0,0,D,"Paisley, Bob",0,Away
2987,1979-05-01,1978.0,Bolton Wanderers,Liverpool,1-4,1,4,1,1,5,-3,A,"Paisley, Bob",4,Away
2988,1979-05-05,1978.0,Liverpool,Southampton,2-0,2,0,1,1,2,2,H,"Paisley, Bob",2,Anfield
2989,1979-05-08,1978.0,Liverpool,Aston Villa,3-0,3,0,1,1,3,3,H,"Paisley, Bob",3,Anfield
2990,1979-05-11,1978.0,Middlesbrough,Liverpool,0-1,0,1,1,1,1,-1,A,"Paisley, Bob",1,Away
2991,1979-05-17,1978.0,Leeds United,Liverpool,0-3,0,3,1,1,3,-3,A,"Paisley, Bob",3,Away
2992,1979-08-21,1979.0,Liverpool,Bolton Wanderers,0-0,0,0,1,1,0,0,D,"Paisley, Bob",0,Anfield
2993,1979-08-25,1979.0,Liverpool,West Bromwich Albion,3-1,3,1,1,1,4,2,H,"Paisley, Bob",3,Anfield
2994,1979-09-01,1979.0,Southampton,Liverpool,3-2,3,2,1,1,5,1,H,"Paisley, Bob",2,Away
2995,1979-09-08,1979.0,Liverpool,Coventry City,4-0,4,0,1,1,4,4,H,"Paisley, Bob",4,Anfield
2996,1979-09-15,1979.0,Leeds United,Liverpool,1-1,1,1,1,1,2,0,D,"Paisley, Bob",1,Away
2997,1979-09-22,1979.0,Liverpool,Norwich City,0-0,0,0,1,1,0,0,D,"Paisley, Bob",0,Anfield
2998,1979-09-29,1979.0,Nottingham Forest,Liverpool,1-0,1,0,1,1,1,1,H,"Paisley, Bob",0,Away
2999,1979-10-06,1979.0,Liverpool,Bristol City,4-0,4,0,1,1,4,4,H,"Paisley, Bob",4,Anfield
3000,1979-10-09,1979.0,Bolton Wanderers,Liverpool,1-1,1,1,1,1,2,0,D,"Paisley, Bob",1,Away
3001,1979-10-13,1979.0,Ipswich Town,Liverpool,1-2,1,2,1,1,3,-1,A,"Paisley, Bob",2,Away
3002,1979-10-20,1979.0,Liverpool,Everton,2-2,2,2,1,1,4,0,D,"Paisley, Bob",2,Anfield
3003,1979-10-27,1979.0,Manchester City,Liverpool,0-4,0,4,1,1,4,-4,A,"Paisley, Bob",4,Away
3004,1979-11-03,1979.0,Liverpool,Wolverhampton Wanderers,3-0,3,0,1,1,3,3,H,"Paisley, Bob",3,Anfield
3005,1979-11-10,1979.0,Brighton & Hove Albion,Liverpool,1-4,1,4,1,1,5,-3,A,"Paisley, Bob",4,Away
3006,1979-11-17,1979.0,Liverpool,Tottenham Hotspur,2-1,2,1,1,1,3,1,H,"Paisley, Bob",2,Anfield
3007,1979-11-24,1979.0,Arsenal,Liverpool,0-0,0,0,1,1,0,0,D,"Paisley, Bob",0,Away
3008,1979-12-01,1979.0,Liverpool,Middlesbrough,4-0,4,0,1,1,4,4,H,"Paisley, Bob",4,Anfield
3009,1979-12-08,1979.0,Aston Villa,Liverpool,1-3,1,3,1,1,4,-2,A,"Paisley, Bob",3,Away
3010,1979-12-15,1979.0,Liverpool,Crystal Palace,3-0,3,0,1,1,3,3,H,"Paisley, Bob",3,Anfield
3011,1979-12-22,1979.0,Derby County,Liverpool,1-3,1,3,1,1,4,-2,A,"Paisley, Bob",3,Away
3012,1979-12-26,1979.0,Liverpool,Manchester United,2-0,2,0,1,1,2,2,H,"Paisley, Bob",2,Anfield
3013,1979-12-29,1979.0,West Bromwich Albion,Liverpool,0-2,0,2,1,1,2,-2,A,"Paisley, Bob",2,Away
3014,1980-01-12,1979.0,Liverpool,Southampton,1-1,1,1,1,1,2,0,D,"Paisley, Bob",1,Anfield
3015,1980-01-19,1979.0,Coventry City,Liverpool,1-0,1,0,1,1,1,1,H,"Paisley, Bob",0,Away
3016,1980-02-09,1979.0,Norwich City,Liverpool,3-5,3,5,1,1,8,-2,A,"Paisley, Bob",5,Away
3017,1980-02-19,1979.0,Liverpool,Nottingham Forest,2-0,2,0,1,1,2,2,H,"Paisley, Bob",2,Anfield
3018,1980-02-23,1979.0,Liverpool,Ipswich Town,1-1,1,1,1,1,2,0,D,"Paisley, Bob",1,Anfield
3019,1980-02-26,1979.0,Wolverhampton Wanderers,Liverpool,1-0,1,0,1,1,1,1,H,"Paisley, Bob",0,Away
3020,1980-03-01,1979.0,Everton,Liverpool,1-2,1,2,1,1,3,-1,A,"Paisley, Bob",2,Away
3021,1980-03-11,1979.0,Liverpool,Manchester City,2-0,2,0,1,1,2,2,H,"Paisley, Bob",2,Anfield
3022,1980-03-15,1979.0,Bristol City,Liverpool,1-3,1,3,1,1,4,-2,A,"Paisley, Bob",3,Away
3023,1980-03-19,1979.0,Liverpool,Leeds United,3-0,3,0,1,1,3,3,H,"Paisley, Bob",3,Anfield
3024,1980-03-22,1979.0,Liverpool,Brighton & Hove Albion,1-0,1,0,1,1,1,1,H,"Paisley, Bob",1,Anfield
3025,1980-03-29,1979.0,Tottenham Hotspur,Liverpool,2-0,2,0,1,1,2,2,H,"Paisley, Bob",0,Away
3026,1980-04-01,1979.0,Liverpool,Stoke City,1-0,1,0,1,1,1,1,H,"Paisley, Bob",1,Anfield
3027,1980-04-05,1979.0,Manchester United,Liverpool,2-1,2,1,1,1,3,1,H,"Paisley, Bob",1,Away
3028,1980-04-08,1979.0,Liverpool,Derby County,3-0,3,0,1,1,3,3,H,"Paisley, Bob",3,Anfield
3029,1980-04-19,1979.0,Liverpool,Arsenal,1-1,1,1,1,1,2,0,D,"Paisley, Bob",1,Anfield
3030,1980-04-23,1979.0,Stoke City,Liverpool,0-2,0,2,1,1,2,-2,A,"Paisley, Bob",2,Away
3031,1980-04-26,1979.0,Crystal Palace,Liverpool,0-0,0,0,1,1,0,0,D,"Paisley, Bob",0,Away
3032,1980-05-03,1979.0,Liverpool,Aston Villa,4-1,4,1,1,1,5,3,H,"Paisley, Bob",4,Anfield
3033,1980-05-06,1979.0,Middlesbrough,Liverpool,1-0,1,0,1,1,1,1,H,"Paisley, Bob",0,Away
3034,1980-08-16,1980.0,Liverpool,Crystal Palace,3-0,3,0,1,1,3,3,H,"Paisley, Bob",3,Anfield
3035,1980-08-19,1980.0,Coventry City,Liverpool,0-0,0,0,1,1,0,0,D,"Paisley, Bob",0,Away
3036,1980-08-23,1980.0,Leicester City,Liverpool,2-0,2,0,1,1,2,2,H,"Paisley, Bob",0,Away
3037,1980-08-30,1980.0,Liverpool,Norwich City,4-1,4,1,1,1,5,3,H,"Paisley, Bob",4,Anfield
3038,1980-09-06,1980.0,Birmingham City,Liverpool,1-1,1,1,1,1,2,0,D,"Paisley, Bob",1,Away
3039,1980-09-13,1980.0,Liverpool,West Bromwich Albion,4-0,4,0,1,1,4,4,H,"Paisley, Bob",4,Anfield
3040,1980-09-20,1980.0,Southampton,Liverpool,2-2,2,2,1,1,4,0,D,"Paisley, Bob",2,Away
3041,1980-09-27,1980.0,Liverpool,Brighton & Hove Albion,4-1,4,1,1,1,5,3,H,"Paisley, Bob",4,Anfield
3042,1980-10-04,1980.0,Manchester City,Liverpool,0-3,0,3,1,1,3,-3,A,"Paisley, Bob",3,Away
3043,1980-10-07,1980.0,Liverpool,Middlesbrough,4-2,4,2,1,1,6,2,H,"Paisley, Bob",4,Anfield
3044,1980-10-11,1980.0,Liverpool,Ipswich Town,1-1,1,1,1,1,2,0,D,"Paisley, Bob",1,Anfield
3045,1980-10-18,1980.0,Everton,Liverpool,2-2,2,2,1,1,4,0,D,"Paisley, Bob",2,Away
3046,1980-10-25,1980.0,Liverpool,Arsenal,1-1,1,1,1,1,2,0,D,"Paisley, Bob",1,Anfield
3047,1980-11-01,1980.0,Stoke City,Liverpool,2-2,2,2,1,1,4,0,D,"Paisley, Bob",2,Away
3048,1980-11-08,1980.0,Liverpool,Nottingham Forest,0-0,0,0,1,1,0,0,D,"Paisley, Bob",0,Anfield
3049,1980-11-11,1980.0,Liverpool,Coventry City,2-1,2,1,1,1,3,1,H,"Paisley, Bob",2,Anfield
3050,1980-11-15,1980.0,Crystal Palace,Liverpool,2-2,2,2,1,1,4,0,D,"Paisley, Bob",2,Away
3051,1980-11-22,1980.0,Liverpool,Aston Villa,2-1,2,1,1,1,3,1,H,"Paisley, Bob",2,Anfield
3052,1980-11-25,1980.0,Wolverhampton Wanderers,Liverpool,4-1,4,1,1,1,5,3,H,"Paisley, Bob",1,Away
3053,1980-11-29,1980.0,Sunderland,Liverpool,2-4,2,4,1,1,6,-2,A,"Paisley, Bob",4,Away
3054,1980-12-06,1980.0,Liverpool,Tottenham Hotspur,2-1,2,1,1,1,3,1,H,"Paisley, Bob",2,Anfield
3055,1980-12-13,1980.0,Ipswich Town,Liverpool,1-1,1,1,1,1,2,0,D,"Paisley, Bob",1,Away
3056,1980-12-20,1980.0,Liverpool,Wolverhampton Wanderers,1-0,1,0,1,1,1,1,H,"Paisley, Bob",1,Anfield
3057,1980-12-26,1980.0,Manchester United,Liverpool,0-0,0,0,1,1,0,0,D,"Paisley, Bob",0,Away
3058,1980-12-27,1980.0,Liverpool,Leeds United,0-0,0,0,1,1,0,0,D,"Paisley, Bob",0,Anfield
3059,1981-01-10,1980.0,Aston Villa,Liverpool,2-0,2,0,1,1,2,2,H,"Paisley, Bob",0,Away
3060,1981-01-17,1980.0,Norwich City,Liverpool,0-1,0,1,1,1,1,-1,A,"Paisley, Bob",1,Away
3061,1981-01-31,1980.0,Liverpool,Leicester City,1-2,1,2,1,1,3,-1,A,"Paisley, Bob",1,Anfield
3062,1981-02-07,1980.0,West Bromwich Albion,Liverpool,2-0,2,0,1,1,2,2,H,"Paisley, Bob",0,Away
3063,1981-02-14,1980.0,Liverpool,Birmingham City,2-2,2,2,1,1,4,0,D,"Paisley, Bob",2,Anfield
3064,1981-02-21,1980.0,Brighton & Hove Albion,Liverpool,2-2,2,2,1,1,4,0,D,"Paisley, Bob",2,Away
3065,1981-02-28,1980.0,Liverpool,Southampton,2-0,2,0,1,1,2,2,H,"Paisley, Bob",2,Anfield
3066,1981-03-21,1980.0,Liverpool,Everton,1-0,1,0,1,1,1,1,H,"Paisley, Bob",1,Anfield
3067,1981-03-28,1980.0,Arsenal,Liverpool,1-0,1,0,1,1,1,1,H,"Paisley, Bob",0,Away
3068,1981-04-03,1980.0,Liverpool,Stoke City,3-0,3,0,1,1,3,3,H,"Paisley, Bob",3,Anfield
3069,1981-04-11,1980.0,Nottingham Forest,Liverpool,0-0,0,0,1,1,0,0,D,"Paisley, Bob",0,Away
3070,1981-04-14,1980.0,Liverpool,Manchester United,0-1,0,1,1,1,1,-1,A,"Paisley, Bob",0,Anfield
3071,1981-04-18,1980.0,Leeds United,Liverpool,0-0,0,0,1,1,0,0,D,"Paisley, Bob",0,Away
3072,1981-04-25,1980.0,Tottenham Hotspur,Liverpool,1-1,1,1,1,1,2,0,D,"Paisley, Bob",1,Away
3073,1981-05-02,1980.0,Liverpool,Sunderland,0-1,0,1,1,1,1,-1,A,"Paisley, Bob",0,Anfield
3074,1981-05-05,1980.0,Middlesbrough,Liverpool,1-2,1,2,1,1,3,-1,A,"Paisley, Bob",2,Away
3075,1981-05-19,1980.0,Liverpool,Manchester City,1-0,1,0,1,1,1,1,H,"Paisley, Bob",1,Anfield
3076,1981-08-29,1981.0,Wolverhampton Wanderers,Liverpool,1-0,1,0,1,1,1,1,H,"Paisley, Bob",0,Away
3077,1981-09-01,1981.0,Liverpool,Middlesbrough,1-1,1,1,1,1,2,0,D,"Paisley, Bob",1,Anfield
3078,1981-09-05,1981.0,Liverpool,Arsenal,2-0,2,0,1,1,2,2,H,"Paisley, Bob",2,Anfield
3079,1981-09-12,1981.0,Ipswich Town,Liverpool,2-0,2,0,1,1,2,2,H,"Paisley, Bob",0,Away
3080,1981-09-19,1981.0,Liverpool,Aston Villa,0-0,0,0,1,1,0,0,D,"Paisley, Bob",0,Anfield
3081,1981-09-22,1981.0,Coventry City,Liverpool,1-2,1,2,1,1,3,-1,A,"Paisley, Bob",2,Away
3082,1981-09-26,1981.0,West Ham United,Liverpool,1-1,1,1,1,1,2,0,D,"Paisley, Bob",1,Away
3083,1981-10-03,1981.0,Liverpool,Swansea City,2-2,2,2,1,1,4,0,D,"Paisley, Bob",2,Anfield
3084,1981-10-10,1981.0,Liverpool,Leeds United,3-0,3,0,1,1,3,3,H,"Paisley, Bob",3,Anfield
3085,1981-10-17,1981.0,Brighton & Hove Albion,Liverpool,3-3,3,3,1,1,6,0,D,"Paisley, Bob",3,Away
3086,1981-10-24,1981.0,Liverpool,Manchester United,1-2,1,2,1,1,3,-1,A,"Paisley, Bob",1,Anfield
3087,1981-10-31,1981.0,Sunderland,Liverpool,0-2,0,2,1,1,2,-2,A,"Paisley, Bob",2,Away
3088,1981-11-07,1981.0,Liverpool,Everton,3-1,3,1,1,1,4,2,H,"Paisley, Bob",3,Anfield
3089,1981-11-21,1981.0,West Bromwich Albion,Liverpool,1-1,1,1,1,1,2,0,D,"Paisley, Bob",1,Away
3090,1981-11-28,1981.0,Liverpool,Southampton,0-1,0,1,1,1,1,-1,A,"Paisley, Bob",0,Anfield
3091,1981-12-05,1981.0,Nottingham Forest,Liverpool,0-2,0,2,1,1,2,-2,A,"Paisley, Bob",2,Away
3092,1981-12-26,1981.0,Liverpool,Manchester City,1-3,1,3,1,1,4,-2,A,"Paisley, Bob",1,Anfield
3093,1982-01-05,1981.0,Liverpool,West Ham United,3-0,3,0,1,1,3,3,H,"Paisley, Bob",3,Anfield
3094,1982-01-16,1981.0,Liverpool,Wolverhampton Wanderers,2-1,2,1,1,1,3,1,H,"Paisley, Bob",2,Anfield
3095,1982-01-26,1981.0,Notts County,Liverpool,0-4,0,4,1,1,4,-4,A,"Paisley, Bob",4,Away
3096,1982-01-30,1981.0,Aston Villa,Liverpool,0-3,0,3,1,1,3,-3,A,"Paisley, Bob",3,Away
3097,1982-02-06,1981.0,Liverpool,Ipswich Town,4-0,4,0,1,1,4,4,H,"Paisley, Bob",4,Anfield
3098,1982-02-16,1981.0,Swansea City,Liverpool,2-0,2,0,1,1,2,2,H,"Paisley, Bob",0,Away
3099,1982-02-20,1981.0,Liverpool,Coventry City,4-0,4,0,1,1,4,4,H,"Paisley, Bob",4,Anfield
3100,1982-02-27,1981.0,Leeds United,Liverpool,0-2,0,2,1,1,2,-2,A,"Paisley, Bob",2,Away
3101,1982-03-06,1981.0,Liverpool,Brighton & Hove Albion,0-1,0,1,1,1,1,-1,A,"Paisley, Bob",0,Anfield
3102,1982-03-09,1981.0,Stoke City,Liverpool,1-5,1,5,1,1,6,-4,A,"Paisley, Bob",5,Away
3103,1982-03-20,1981.0,Liverpool,Sunderland,1-0,1,0,1,1,1,1,H,"Paisley, Bob",1,Anfield
3104,1982-03-27,1981.0,Everton,Liverpool,1-3,1,3,1,1,4,-2,A,"Paisley, Bob",3,Away
3105,1982-03-30,1981.0,Liverpool,Birmingham City,3-1,3,1,1,1,4,2,H,"Paisley, Bob",3,Anfield
3106,1982-04-02,1981.0,Liverpool,Notts County,1-0,1,0,1,1,1,1,H,"Paisley, Bob",1,Anfield
3107,1982-04-07,1981.0,Manchester United,Liverpool,0-1,0,1,1,1,1,-1,A,"Paisley, Bob",1,Away
3108,1982-04-10,1981.0,Manchester City,Liverpool,0-5,0,5,1,1,5,-5,A,"Paisley, Bob",5,Away
3109,1982-04-13,1981.0,Liverpool,Stoke City,2-0,2,0,1,1,2,2,H,"Paisley, Bob",2,Anfield
3110,1982-04-17,1981.0,Liverpool,West Bromwich Albion,1-0,1,0,1,1,1,1,H,"Paisley, Bob",1,Anfield
3111,1982-04-24,1981.0,Southampton,Liverpool,2-3,2,3,1,1,5,-1,A,"Paisley, Bob",3,Away
3112,1982-05-01,1981.0,Liverpool,Nottingham Forest,2-0,2,0,1,1,2,2,H,"Paisley, Bob",2,Anfield
3113,1982-05-03,1981.0,Tottenham Hotspur,Liverpool,2-2,2,2,1,1,4,0,D,"Paisley, Bob",2,Away
3114,1982-05-08,1981.0,Birmingham City,Liverpool,0-1,0,1,1,1,1,-1,A,"Paisley, Bob",1,Away
3115,1982-05-11,1981.0,Arsenal,Liverpool,1-1,1,1,1,1,2,0,D,"Paisley, Bob",1,Away
3116,1982-05-15,1981.0,Liverpool,Tottenham Hotspur,3-1,3,1,1,1,4,2,H,"Paisley, Bob",3,Anfield
3117,1982-05-18,1981.0,Middlesbrough,Liverpool,0-0,0,0,1,1,0,0,D,"Paisley, Bob",0,Away
3118,1982-08-28,1982.0,Liverpool,West Bromwich Albion,2-0,2,0,1,1,2,2,H,"Paisley, Bob",2,Anfield
3119,1982-08-31,1982.0,Birmingham City,Liverpool,0-0,0,0,1,1,0,0,D,"Paisley, Bob",0,Away
3120,1982-09-04,1982.0,Arsenal,Liverpool,0-2,0,2,1,1,2,-2,A,"Paisley, Bob",2,Away
3121,1982-09-07,1982.0,Liverpool,Nottingham Forest,4-3,4,3,1,1,7,1,H,"Paisley, Bob",4,Anfield
3122,1982-09-11,1982.0,Liverpool,Luton Town,3-3,3,3,1,1,6,0,D,"Paisley, Bob",3,Anfield
3123,1982-09-18,1982.0,Swansea City,Liverpool,0-3,0,3,1,1,3,-3,A,"Paisley, Bob",3,Away
3124,1982-09-25,1982.0,Liverpool,Southampton,5-0,5,0,1,1,5,5,H,"Paisley, Bob",5,Anfield
3125,1982-10-02,1982.0,Ipswich Town,Liverpool,1-0,1,0,1,1,1,1,H,"Paisley, Bob",0,Away
3126,1982-10-09,1982.0,West Ham United,Liverpool,3-1,3,1,1,1,4,2,H,"Paisley, Bob",1,Away
3127,1982-10-16,1982.0,Liverpool,Manchester United,0-0,0,0,1,1,0,0,D,"Paisley, Bob",0,Anfield
3128,1982-10-23,1982.0,Stoke City,Liverpool,1-1,1,1,1,1,2,0,D,"Paisley, Bob",1,Away
3129,1982-10-30,1982.0,Liverpool,Brighton & Hove Albion,3-1,3,1,1,1,4,2,H,"Paisley, Bob",3,Anfield
3130,1982-11-06,1982.0,Everton,Liverpool,0-5,0,5,1,1,5,-5,A,"Paisley, Bob",5,Away
3131,1982-11-13,1982.0,Liverpool,Coventry City,4-0,4,0,1,1,4,4,H,"Paisley, Bob",4,Anfield
3132,1982-11-20,1982.0,Notts County,Liverpool,1-2,1,2,1,1,3,-1,A,"Paisley, Bob",2,Away
3133,1982-11-27,1982.0,Liverpool,Tottenham Hotspur,3-0,3,0,1,1,3,3,H,"Paisley, Bob",3,Anfield
3134,1982-12-04,1982.0,Norwich City,Liverpool,1-0,1,0,1,1,1,1,H,"Paisley, Bob",0,Away
3135,1982-12-11,1982.0,Liverpool,Watford,3-1,3,1,1,1,4,2,H,"Paisley, Bob",3,Anfield
3136,1982-12-18,1982.0,Aston Villa,Liverpool,2-4,2,4,1,1,6,-2,A,"Paisley, Bob",4,Away
3137,1982-12-27,1982.0,Liverpool,Manchester City,5-2,5,2,1,1,7,3,H,"Paisley, Bob",5,Anfield
3138,1982-12-28,1982.0,Sunderland,Liverpool,0-0,0,0,1,1,0,0,D,"Paisley, Bob",0,Away
3139,1983-01-01,1982.0,Liverpool,Notts County,5-1,5,1,1,1,6,4,H,"Paisley, Bob",5,Anfield
3140,1983-01-03,1982.0,Liverpool,Arsenal,3-1,3,1,1,1,4,2,H,"Paisley, Bob",3,Anfield
3141,1983-01-15,1982.0,West Bromwich Albion,Liverpool,0-1,0,1,1,1,1,-1,A,"Paisley, Bob",1,Away
3142,1983-01-22,1982.0,Liverpool,Birmingham City,1-0,1,0,1,1,1,1,H,"Paisley, Bob",1,Anfield
3143,1983-02-05,1982.0,Luton Town,Liverpool,1-3,1,3,1,1,4,-2,A,"Paisley, Bob",3,Away
3144,1983-02-12,1982.0,Liverpool,Ipswich Town,1-0,1,0,1,1,1,1,H,"Paisley, Bob",1,Anfield
3145,1983-02-26,1982.0,Manchester United,Liverpool,1-1,1,1,1,1,2,0,D,"Paisley, Bob",1,Away
3146,1983-03-05,1982.0,Liverpool,Stoke City,5-1,5,1,1,1,6,4,H,"Paisley, Bob",5,Anfield
3147,1983-03-12,1982.0,Liverpool,West Ham United,3-0,3,0,1,1,3,3,H,"Paisley, Bob",3,Anfield
3148,1983-03-19,1982.0,Liverpool,Everton,0-0,0,0,1,1,0,0,D,"Paisley, Bob",0,Anfield
3149,1983-03-22,1982.0,Brighton & Hove Albion,Liverpool,2-2,2,2,1,1,4,0,D,"Paisley, Bob",2,Away
3150,1983-04-02,1982.0,Liverpool,Sunderland,1-0,1,0,1,1,1,1,H,"Paisley, Bob",1,Anfield
3151,1983-04-04,1982.0,Manchester City,Liverpool,0-4,0,4,1,1,4,-4,A,"Paisley, Bob",4,Away
3152,1983-04-09,1982.0,Liverpool,Swansea City,3-0,3,0,1,1,3,3,H,"Paisley, Bob",3,Anfield
3153,1983-04-12,1982.0,Coventry City,Liverpool,0-0,0,0,1,1,0,0,D,"Paisley, Bob",0,Away
3154,1983-04-16,1982.0,Southampton,Liverpool,3-2,3,2,1,1,5,1,H,"Paisley, Bob",2,Away
3155,1983-04-23,1982.0,Liverpool,Norwich City,0-2,0,2,1,1,2,-2,A,"Paisley, Bob",0,Anfield
3156,1983-04-30,1982.0,Tottenham Hotspur,Liverpool,2-0,2,0,1,1,2,2,H,"Paisley, Bob",0,Away
3157,1983-05-02,1982.0,Nottingham Forest,Liverpool,1-0,1,0,1,1,1,1,H,"Paisley, Bob",0,Away
3158,1983-05-07,1982.0,Liverpool,Aston Villa,1-1,1,1,1,1,2,0,D,"Paisley, Bob",1,Anfield
3159,1983-05-14,1982.0,Watford,Liverpool,2-1,2,1,1,1,3,1,H,"Paisley, Bob",1,Away
3160,1983-08-27,1983.0,Wolverhampton Wanderers,Liverpool,1-1,1,1,1,1,2,0,D,"Fagan, Joe",1,Away
3161,1983-08-31,1983.0,Norwich City,Liverpool,0-1,0,1,1,1,1,-1,A,"Fagan, Joe",1,Away
3162,1983-09-03,1983.0,Liverpool,Nottingham Forest,1-0,1,0,1,1,1,1,H,"Fagan, Joe",1,Anfield
3163,1983-09-06,1983.0,Liverpool,Southampton,1-1,1,1,1,1,2,0,D,"Fagan, Joe",1,Anfield
3164,1983-09-10,1983.0,Arsenal,Liverpool,0-2,0,2,1,1,2,-2,A,"Fagan, Joe",2,Away
3165,1983-09-17,1983.0,Liverpool,Aston Villa,2-1,2,1,1,1,3,1,H,"Fagan, Joe",2,Anfield
3166,1983-09-24,1983.0,Manchester United,Liverpool,1-0,1,0,1,1,1,1,H,"Fagan, Joe",0,Away
3167,1983-10-01,1983.0,Liverpool,Sunderland,0-1,0,1,1,1,1,-1,A,"Fagan, Joe",0,Anfield
3168,1983-10-15,1983.0,West Ham United,Liverpool,1-3,1,3,1,1,4,-2,A,"Fagan, Joe",3,Away
3169,1983-10-22,1983.0,Queens Park Rangers,Liverpool,0-1,0,1,1,1,1,-1,A,"Fagan, Joe",1,Away
3170,1983-10-29,1983.0,Liverpool,Luton Town,6-0,6,0,1,1,6,6,H,"Fagan, Joe",6,Anfield
3171,1983-11-06,1983.0,Liverpool,Everton,3-0,3,0,1,1,3,3,H,"Fagan, Joe",3,Anfield
3172,1983-11-12,1983.0,Tottenham Hotspur,Liverpool,2-2,2,2,1,1,4,0,D,"Fagan, Joe",2,Away
3173,1983-11-19,1983.0,Liverpool,Stoke City,1-0,1,0,1,1,1,1,H,"Fagan, Joe",1,Anfield
3174,1983-11-26,1983.0,Ipswich Town,Liverpool,1-1,1,1,1,1,2,0,D,"Fagan, Joe",1,Away
3175,1983-12-03,1983.0,Liverpool,Birmingham City,1-0,1,0,1,1,1,1,H,"Fagan, Joe",1,Anfield
3176,1983-12-10,1983.0,Coventry City,Liverpool,4-0,4,0,1,1,4,4,H,"Fagan, Joe",0,Away
3177,1983-12-17,1983.0,Liverpool,Notts County,5-0,5,0,1,1,5,5,H,"Fagan, Joe",5,Anfield
3178,1983-12-26,1983.0,West Bromwich Albion,Liverpool,1-2,1,2,1,1,3,-1,A,"Fagan, Joe",2,Away
3179,1983-12-27,1983.0,Liverpool,Leicester City,2-2,2,2,1,1,4,0,D,"Fagan, Joe",2,Anfield
3180,1983-12-31,1983.0,Nottingham Forest,Liverpool,0-1,0,1,1,1,1,-1,A,"Fagan, Joe",1,Away
3181,1984-01-02,1983.0,Liverpool,Manchester United,1-1,1,1,1,1,2,0,D,"Fagan, Joe",1,Anfield
3182,1984-01-14,1983.0,Liverpool,Wolverhampton Wanderers,0-1,0,1,1,1,1,-1,A,"Fagan, Joe",0,Anfield
3183,1984-01-20,1983.0,Aston Villa,Liverpool,1-3,1,3,1,1,4,-2,A,"Fagan, Joe",3,Away
3184,1984-02-01,1983.0,Liverpool,Watford,3-0,3,0,1,1,3,3,H,"Fagan, Joe",3,Anfield
3185,1984-02-04,1983.0,Sunderland,Liverpool,0-0,0,0,1,1,0,0,D,"Fagan, Joe",0,Away
3186,1984-02-11,1983.0,Liverpool,Arsenal,2-1,2,1,1,1,3,1,H,"Fagan, Joe",2,Anfield
3187,1984-02-18,1983.0,Luton Town,Liverpool,0-0,0,0,1,1,0,0,D,"Fagan, Joe",0,Away
3188,1984-02-25,1983.0,Liverpool,Queens Park Rangers,2-0,2,0,1,1,2,2,H,"Fagan, Joe",2,Anfield
3189,1984-03-03,1983.0,Everton,Liverpool,1-1,1,1,1,1,2,0,D,"Fagan, Joe",1,Away
3190,1984-03-10,1983.0,Liverpool,Tottenham Hotspur,3-1,3,1,1,1,4,2,H,"Fagan, Joe",3,Anfield
3191,1984-03-16,1983.0,Southampton,Liverpool,2-0,2,0,1,1,2,2,H,"Fagan, Joe",0,Away
3192,1984-03-31,1983.0,Watford,Liverpool,0-2,0,2,1,1,2,-2,A,"Fagan, Joe",2,Away
3193,1984-04-07,1983.0,Liverpool,West Ham United,6-0,6,0,1,1,6,6,H,"Fagan, Joe",6,Anfield
3194,1984-04-14,1983.0,Stoke City,Liverpool,2-0,2,0,1,1,2,2,H,"Fagan, Joe",0,Away
3195,1984-04-18,1983.0,Leicester City,Liverpool,3-3,3,3,1,1,6,0,D,"Fagan, Joe",3,Away
3196,1984-04-21,1983.0,Liverpool,West Bromwich Albion,3-0,3,0,1,1,3,3,H,"Fagan, Joe",3,Anfield
3197,1984-04-28,1983.0,Liverpool,Ipswich Town,2-2,2,2,1,1,4,0,D,"Fagan, Joe",2,Anfield
3198,1984-05-05,1983.0,Birmingham City,Liverpool,0-0,0,0,1,1,0,0,D,"Fagan, Joe",0,Away
3199,1984-05-07,1983.0,Liverpool,Coventry City,5-0,5,0,1,1,5,5,H,"Fagan, Joe",5,Anfield
3200,1984-05-12,1983.0,Notts County,Liverpool,0-0,0,0,1,1,0,0,D,"Fagan, Joe",0,Away
3201,1984-05-15,1983.0,Liverpool,Norwich City,1-1,1,1,1,1,2,0,D,"Fagan, Joe",1,Anfield
3202,1984-08-25,1984.0,Norwich City,Liverpool,3-3,3,3,1,1,6,0,D,"Fagan, Joe",3,Away
3203,1984-08-27,1984.0,Liverpool,West Ham United,3-0,3,0,1,1,3,3,H,"Fagan, Joe",3,Anfield
3204,1984-09-01,1984.0,Liverpool,Queens Park Rangers,1-1,1,1,1,1,2,0,D,"Fagan, Joe",1,Anfield
3205,1984-09-04,1984.0,Luton Town,Liverpool,1-2,1,2,1,1,3,-1,A,"Fagan, Joe",2,Away
3206,1984-09-08,1984.0,Arsenal,Liverpool,3-1,3,1,1,1,4,2,H,"Fagan, Joe",1,Away
3207,1984-09-15,1984.0,Liverpool,Sunderland,1-1,1,1,1,1,2,0,D,"Fagan, Joe",1,Anfield
3208,1984-09-22,1984.0,Manchester United,Liverpool,1-1,1,1,1,1,2,0,D,"Fagan, Joe",1,Away
3209,1984-09-29,1984.0,Liverpool,Sheffield Wednesday,0-2,0,2,1,1,2,-2,A,"Fagan, Joe",0,Anfield
3210,1984-10-06,1984.0,Liverpool,West Bromwich Albion,0-0,0,0,1,1,0,0,D,"Fagan, Joe",0,Anfield
3211,1984-10-12,1984.0,Tottenham Hotspur,Liverpool,1-0,1,0,1,1,1,1,H,"Fagan, Joe",0,Away
3212,1984-10-20,1984.0,Liverpool,Everton,0-1,0,1,1,1,1,-1,A,"Fagan, Joe",0,Anfield
3213,1984-10-28,1984.0,Nottingham Forest,Liverpool,0-2,0,2,1,1,2,-2,A,"Fagan, Joe",2,Away
3214,1984-11-03,1984.0,Stoke City,Liverpool,0-1,0,1,1,1,1,-1,A,"Fagan, Joe",1,Away
3215,1984-11-10,1984.0,Liverpool,Southampton,1-1,1,1,1,1,2,0,D,"Fagan, Joe",1,Anfield
3216,1984-11-18,1984.0,Newcastle United,Liverpool,0-2,0,2,1,1,2,-2,A,"Fagan, Joe",2,Away
3217,1984-11-24,1984.0,Liverpool,Ipswich Town,2-0,2,0,1,1,2,2,H,"Fagan, Joe",2,Anfield
3218,1984-12-01,1984.0,Chelsea,Liverpool,3-1,3,1,1,1,4,2,H,"Fagan, Joe",1,Away
3219,1984-12-04,1984.0,Liverpool,Coventry City,3-1,3,1,1,1,4,2,H,"Fagan, Joe",3,Anfield
3220,1984-12-15,1984.0,Aston Villa,Liverpool,0-0,0,0,1,1,0,0,D,"Fagan, Joe",0,Away
3221,1984-12-21,1984.0,Queens Park Rangers,Liverpool,0-2,0,2,1,1,2,-2,A,"Fagan, Joe",2,Away
3222,1984-12-26,1984.0,Liverpool,Leicester City,1-2,1,2,1,1,3,-1,A,"Fagan, Joe",1,Anfield
3223,1984-12-29,1984.0,Liverpool,Luton Town,1-0,1,0,1,1,1,1,H,"Fagan, Joe",1,Anfield
3224,1985-01-01,1984.0,Watford,Liverpool,1-1,1,1,1,1,2,0,D,"Fagan, Joe",1,Away
3225,1985-01-19,1984.0,Liverpool,Norwich City,4-0,4,0,1,1,4,4,H,"Fagan, Joe",4,Anfield
3226,1985-02-02,1984.0,Sheffield Wednesday,Liverpool,1-1,1,1,1,1,2,0,D,"Fagan, Joe",1,Away
3227,1985-02-12,1984.0,Liverpool,Arsenal,3-0,3,0,1,1,3,3,H,"Fagan, Joe",3,Anfield
3228,1985-02-23,1984.0,Liverpool,Stoke City,2-0,2,0,1,1,2,2,H,"Fagan, Joe",2,Anfield
3229,1985-03-02,1984.0,Liverpool,Nottingham Forest,1-0,1,0,1,1,1,1,H,"Fagan, Joe",1,Anfield
3230,1985-03-16,1984.0,Liverpool,Tottenham Hotspur,0-1,0,1,1,1,1,-1,A,"Fagan, Joe",0,Anfield
3231,1985-03-23,1984.0,West Bromwich Albion,Liverpool,0-5,0,5,1,1,5,-5,A,"Fagan, Joe",5,Away
3232,1985-03-31,1984.0,Liverpool,Manchester United,0-1,0,1,1,1,1,-1,A,"Fagan, Joe",0,Anfield
3233,1985-04-03,1984.0,Sunderland,Liverpool,0-3,0,3,1,1,3,-3,A,"Fagan, Joe",3,Away
3234,1985-04-06,1984.0,Leicester City,Liverpool,0-1,0,1,1,1,1,-1,A,"Fagan, Joe",1,Away
3235,1985-04-20,1984.0,Liverpool,Newcastle United,3-1,3,1,1,1,4,2,H,"Fagan, Joe",3,Anfield
3236,1985-04-27,1984.0,Ipswich Town,Liverpool,0-0,0,0,1,1,0,0,D,"Fagan, Joe",0,Away
3237,1985-05-04,1984.0,Liverpool,Chelsea,4-3,4,3,1,1,7,1,H,"Fagan, Joe",4,Anfield
3238,1985-05-06,1984.0,Coventry City,Liverpool,0-2,0,2,1,1,2,-2,A,"Fagan, Joe",2,Away
3239,1985-05-11,1984.0,Liverpool,Aston Villa,2-1,2,1,1,1,3,1,H,"Fagan, Joe",2,Anfield
3240,1985-05-14,1984.0,Southampton,Liverpool,1-1,1,1,1,1,2,0,D,"Fagan, Joe",1,Away
3241,1985-05-17,1984.0,Liverpool,Watford,4-3,4,3,1,1,7,1,H,"Fagan, Joe",4,Anfield
3242,1985-05-20,1984.0,West Ham United,Liverpool,0-3,0,3,1,1,3,-3,A,"Fagan, Joe",3,Away
3243,1985-05-23,1984.0,Everton,Liverpool,1-0,1,0,1,1,1,1,H,"Fagan, Joe",0,Away
3244,1985-08-17,1985.0,Liverpool,Arsenal,2-0,2,0,1,1,2,2,H,"Dalglish, Kenny",2,Anfield
3245,1985-08-21,1985.0,Aston Villa,Liverpool,2-2,2,2,1,1,4,0,D,"Dalglish, Kenny",2,Away
3246,1985-08-24,1985.0,Newcastle United,Liverpool,1-0,1,0,1,1,1,1,H,"Dalglish, Kenny",0,Away
3247,1985-08-26,1985.0,Liverpool,Ipswich Town,5-0,5,0,1,1,5,5,H,"Dalglish, Kenny",5,Anfield
3248,1985-08-31,1985.0,West Ham United,Liverpool,2-2,2,2,1,1,4,0,D,"Dalglish, Kenny",2,Away
3249,1985-09-03,1985.0,Liverpool,Nottingham Forest,2-0,2,0,1,1,2,2,H,"Dalglish, Kenny",2,Anfield
3250,1985-09-07,1985.0,Liverpool,Watford,3-1,3,1,1,1,4,2,H,"Dalglish, Kenny",3,Anfield
3251,1985-09-14,1985.0,Oxford United,Liverpool,2-2,2,2,1,1,4,0,D,"Dalglish, Kenny",2,Away
3252,1985-09-21,1985.0,Everton,Liverpool,2-3,2,3,1,1,5,-1,A,"Dalglish, Kenny",3,Away
3253,1985-09-28,1985.0,Liverpool,Tottenham Hotspur,4-1,4,1,1,1,5,3,H,"Dalglish, Kenny",4,Anfield
3254,1985-10-05,1985.0,Queens Park Rangers,Liverpool,2-1,2,1,1,1,3,1,H,"Dalglish, Kenny",1,Away
3255,1985-10-12,1985.0,Liverpool,Southampton,1-0,1,0,1,1,1,1,H,"Dalglish, Kenny",1,Anfield
3256,1985-10-19,1985.0,Manchester United,Liverpool,1-1,1,1,1,1,2,0,D,"Dalglish, Kenny",1,Away
3257,1985-10-26,1985.0,Liverpool,Luton Town,3-2,3,2,1,1,5,1,H,"Dalglish, Kenny",3,Anfield
3258,1985-11-02,1985.0,Liverpool,Leicester City,1-0,1,0,1,1,1,1,H,"Dalglish, Kenny",1,Anfield
3259,1985-11-09,1985.0,Coventry City,Liverpool,0-3,0,3,1,1,3,-3,A,"Dalglish, Kenny",3,Away
3260,1985-11-16,1985.0,Liverpool,West Bromwich Albion,4-1,4,1,1,1,5,3,H,"Dalglish, Kenny",4,Anfield
3261,1985-11-23,1985.0,Birmingham City,Liverpool,0-2,0,2,1,1,2,-2,A,"Dalglish, Kenny",2,Away
3262,1985-11-30,1985.0,Liverpool,Chelsea,1-1,1,1,1,1,2,0,D,"Dalglish, Kenny",1,Anfield
3263,1985-12-07,1985.0,Liverpool,Aston Villa,3-0,3,0,1,1,3,3,H,"Dalglish, Kenny",3,Anfield
3264,1985-12-14,1985.0,Arsenal,Liverpool,2-0,2,0,1,1,2,2,H,"Dalglish, Kenny",0,Away
3265,1985-12-21,1985.0,Liverpool,Newcastle United,1-1,1,1,1,1,2,0,D,"Dalglish, Kenny",1,Anfield
3266,1985-12-26,1985.0,Manchester City,Liverpool,1-0,1,0,1,1,1,1,H,"Dalglish, Kenny",0,Away
3267,1985-12-28,1985.0,Nottingham Forest,Liverpool,1-1,1,1,1,1,2,0,D,"Dalglish, Kenny",1,Away
3268,1986-01-01,1985.0,Liverpool,Sheffield Wednesday,2-2,2,2,1,1,4,0,D,"Dalglish, Kenny",2,Anfield
3269,1986-01-12,1985.0,Watford,Liverpool,2-3,2,3,1,1,5,-1,A,"Dalglish, Kenny",3,Away
3270,1986-01-18,1985.0,Liverpool,West Ham United,3-1,3,1,1,1,4,2,H,"Dalglish, Kenny",3,Anfield
3271,1986-02-01,1985.0,Ipswich Town,Liverpool,2-1,2,1,1,1,3,1,H,"Dalglish, Kenny",1,Away
3272,1986-02-09,1985.0,Liverpool,Manchester United,1-1,1,1,1,1,2,0,D,"Dalglish, Kenny",1,Anfield
3273,1986-02-22,1985.0,Liverpool,Everton,0-2,0,2,1,1,2,-2,A,"Dalglish, Kenny",0,Anfield
3274,1986-03-02,1985.0,Tottenham Hotspur,Liverpool,1-2,1,2,1,1,3,-1,A,"Dalglish, Kenny",2,Away
3275,1986-03-08,1985.0,Liverpool,Queens Park Rangers,4-1,4,1,1,1,5,3,H,"Dalglish, Kenny",4,Anfield
3276,1986-03-15,1985.0,Southampton,Liverpool,1-2,1,2,1,1,3,-1,A,"Dalglish, Kenny",2,Away
3277,1986-03-22,1985.0,Liverpool,Oxford United,6-0,6,0,1,1,6,6,H,"Dalglish, Kenny",6,Anfield
3278,1986-03-29,1985.0,Sheffield Wednesday,Liverpool,0-0,0,0,1,1,0,0,D,"Dalglish, Kenny",0,Away
3279,1986-03-31,1985.0,Liverpool,Manchester City,2-0,2,0,1,1,2,2,H,"Dalglish, Kenny",2,Anfield
3280,1986-04-12,1985.0,Liverpool,Coventry City,5-0,5,0,1,1,5,5,H,"Dalglish, Kenny",5,Anfield
3281,1986-04-16,1985.0,Luton Town,Liverpool,0-1,0,1,1,1,1,-1,A,"Dalglish, Kenny",1,Away
3282,1986-04-19,1985.0,West Bromwich Albion,Liverpool,1-2,1,2,1,1,3,-1,A,"Dalglish, Kenny",2,Away
3283,1986-04-26,1985.0,Liverpool,Birmingham City,5-0,5,0,1,1,5,5,H,"Dalglish, Kenny",5,Anfield
3284,1986-04-30,1985.0,Leicester City,Liverpool,0-2,0,2,1,1,2,-2,A,"Dalglish, Kenny",2,Away
3285,1986-05-03,1985.0,Chelsea,Liverpool,0-1,0,1,1,1,1,-1,A,"Dalglish, Kenny",1,Away
3286,1986-08-23,1986.0,Newcastle United,Liverpool,0-2,0,2,1,1,2,-2,A,"Dalglish, Kenny",2,Away
3287,1986-08-25,1986.0,Liverpool,Manchester City,0-0,0,0,1,1,0,0,D,"Dalglish, Kenny",0,Anfield
3288,1986-08-30,1986.0,Liverpool,Arsenal,2-1,2,1,1,1,3,1,H,"Dalglish, Kenny",2,Anfield
3289,1986-09-03,1986.0,Leicester City,Liverpool,2-1,2,1,1,1,3,1,H,"Dalglish, Kenny",1,Away
3290,1986-09-06,1986.0,West Ham United,Liverpool,2-5,2,5,1,1,7,-3,A,"Dalglish, Kenny",5,Away
3291,1986-09-13,1986.0,Liverpool,Charlton Athletic,2-0,2,0,1,1,2,2,H,"Dalglish, Kenny",2,Anfield
3292,1986-09-20,1986.0,Southampton,Liverpool,2-1,2,1,1,1,3,1,H,"Dalglish, Kenny",1,Away
3293,1986-09-27,1986.0,Liverpool,Aston Villa,3-3,3,3,1,1,6,0,D,"Dalglish, Kenny",3,Anfield
3294,1986-10-04,1986.0,Wimbledon,Liverpool,1-3,1,3,1,1,4,-2,A,"Dalglish, Kenny",3,Away
3295,1986-10-11,1986.0,Liverpool,Tottenham Hotspur,0-1,0,1,1,1,1,-1,A,"Dalglish, Kenny",0,Anfield
3296,1986-10-18,1986.0,Liverpool,Oxford United,4-0,4,0,1,1,4,4,H,"Dalglish, Kenny",4,Anfield
3297,1986-10-25,1986.0,Luton Town,Liverpool,4-1,4,1,1,1,5,3,H,"Dalglish, Kenny",1,Away
3298,1986-11-01,1986.0,Liverpool,Norwich City,6-2,6,2,1,1,8,4,H,"Dalglish, Kenny",6,Anfield
3299,1986-11-08,1986.0,Queens Park Rangers,Liverpool,1-3,1,3,1,1,4,-2,A,"Dalglish, Kenny",3,Away
3300,1986-11-16,1986.0,Liverpool,Sheffield Wednesday,1-1,1,1,1,1,2,0,D,"Dalglish, Kenny",1,Anfield
3301,1986-11-23,1986.0,Everton,Liverpool,0-0,0,0,1,1,0,0,D,"Dalglish, Kenny",0,Away
3302,1986-11-29,1986.0,Liverpool,Coventry City,2-0,2,0,1,1,2,2,H,"Dalglish, Kenny",2,Anfield
3303,1986-12-06,1986.0,Watford,Liverpool,2-0,2,0,1,1,2,2,H,"Dalglish, Kenny",0,Away
3304,1986-12-14,1986.0,Liverpool,Chelsea,3-0,3,0,1,1,3,3,H,"Dalglish, Kenny",3,Anfield
3305,1986-12-20,1986.0,Charlton Athletic,Liverpool,0-0,0,0,1,1,0,0,D,"Dalglish, Kenny",0,Away
3306,1986-12-26,1986.0,Liverpool,Manchester United,0-1,0,1,1,1,1,-1,A,"Dalglish, Kenny",0,Anfield
3307,1986-12-27,1986.0,Sheffield Wednesday,Liverpool,0-1,0,1,1,1,1,-1,A,"Dalglish, Kenny",1,Away
3308,1987-01-01,1986.0,Nottingham Forest,Liverpool,1-1,1,1,1,1,2,0,D,"Dalglish, Kenny",1,Away
3309,1987-01-03,1986.0,Liverpool,West Ham United,1-0,1,0,1,1,1,1,H,"Dalglish, Kenny",1,Anfield
3310,1987-01-17,1986.0,Manchester City,Liverpool,0-1,0,1,1,1,1,-1,A,"Dalglish, Kenny",1,Away
3311,1987-01-24,1986.0,Liverpool,Newcastle United,2-0,2,0,1,1,2,2,H,"Dalglish, Kenny",2,Anfield
3312,1987-02-14,1986.0,Liverpool,Leicester City,4-3,4,3,1,1,7,1,H,"Dalglish, Kenny",4,Anfield
3313,1987-02-21,1986.0,Aston Villa,Liverpool,2-2,2,2,1,1,4,0,D,"Dalglish, Kenny",2,Away
3314,1987-02-28,1986.0,Liverpool,Southampton,1-0,1,0,1,1,1,1,H,"Dalglish, Kenny",1,Anfield
3315,1987-03-07,1986.0,Liverpool,Luton Town,2-0,2,0,1,1,2,2,H,"Dalglish, Kenny",2,Anfield
3316,1987-03-10,1986.0,Arsenal,Liverpool,0-1,0,1,1,1,1,-1,A,"Dalglish, Kenny",1,Away
3317,1987-03-14,1986.0,Oxford United,Liverpool,1-3,1,3,1,1,4,-2,A,"Dalglish, Kenny",3,Away
3318,1987-03-18,1986.0,Liverpool,Queens Park Rangers,2-1,2,1,1,1,3,1,H,"Dalglish, Kenny",2,Anfield
3319,1987-03-22,1986.0,Tottenham Hotspur,Liverpool,1-0,1,0,1,1,1,1,H,"Dalglish, Kenny",0,Away
3320,1987-03-28,1986.0,Liverpool,Wimbledon,1-2,1,2,1,1,3,-1,A,"Dalglish, Kenny",1,Anfield
3321,1987-04-11,1986.0,Norwich City,Liverpool,2-1,2,1,1,1,3,1,H,"Dalglish, Kenny",1,Away
3322,1987-04-18,1986.0,Liverpool,Nottingham Forest,3-0,3,0,1,1,3,3,H,"Dalglish, Kenny",3,Anfield
3323,1987-04-20,1986.0,Manchester United,Liverpool,1-0,1,0,1,1,1,1,H,"Dalglish, Kenny",0,Away
3324,1987-04-25,1986.0,Liverpool,Everton,3-1,3,1,1,1,4,2,H,"Dalglish, Kenny",3,Anfield
3325,1987-05-02,1986.0,Coventry City,Liverpool,1-0,1,0,1,1,1,1,H,"Dalglish, Kenny",0,Away
3326,1987-05-04,1986.0,Liverpool,Watford,1-0,1,0,1,1,1,1,H,"Dalglish, Kenny",1,Anfield
3327,1987-05-09,1986.0,Chelsea,Liverpool,3-3,3,3,1,1,6,0,D,"Dalglish, Kenny",3,Away
3328,1987-08-15,1987.0,Arsenal,Liverpool,1-2,1,2,1,1,3,-1,A,"Dalglish, Kenny",2,Away
3329,1987-08-29,1987.0,Coventry City,Liverpool,1-4,1,4,1,1,5,-3,A,"Dalglish, Kenny",4,Away
3330,1987-09-05,1987.0,West Ham United,Liverpool,1-1,1,1,1,1,2,0,D,"Dalglish, Kenny",1,Away
3331,1987-09-12,1987.0,Liverpool,Oxford United,2-0,2,0,1,1,2,2,H,"Dalglish, Kenny",2,Anfield
3332,1987-09-15,1987.0,Liverpool,Charlton Athletic,3-2,3,2,1,1,5,1,H,"Dalglish, Kenny",3,Anfield
3333,1987-09-20,1987.0,Newcastle United,Liverpool,1-4,1,4,1,1,5,-3,A,"Dalglish, Kenny",4,Away
3334,1987-09-29,1987.0,Liverpool,Derby County,4-0,4,0,1,1,4,4,H,"Dalglish, Kenny",4,Anfield
3335,1987-10-03,1987.0,Liverpool,Portsmouth,4-0,4,0,1,1,4,4,H,"Dalglish, Kenny",4,Anfield
3336,1987-10-17,1987.0,Liverpool,Queens Park Rangers,4-0,4,0,1,1,4,4,H,"Dalglish, Kenny",4,Anfield
3337,1987-10-24,1987.0,Luton Town,Liverpool,0-1,0,1,1,1,1,-1,A,"Dalglish, Kenny",1,Away
3338,1987-11-01,1987.0,Liverpool,Everton,2-0,2,0,1,1,2,2,H,"Dalglish, Kenny",2,Anfield
3339,1987-11-04,1987.0,Wimbledon,Liverpool,1-1,1,1,1,1,2,0,D,"Dalglish, Kenny",1,Away
3340,1987-11-15,1987.0,Manchester United,Liverpool,1-1,1,1,1,1,2,0,D,"Dalglish, Kenny",1,Away
3341,1987-11-21,1987.0,Liverpool,Norwich City,0-0,0,0,1,1,0,0,D,"Dalglish, Kenny",0,Anfield
3342,1987-11-24,1987.0,Liverpool,Watford,4-0,4,0,1,1,4,4,H,"Dalglish, Kenny",4,Anfield
3343,1987-11-28,1987.0,Tottenham Hotspur,Liverpool,0-2,0,2,1,1,2,-2,A,"Dalglish, Kenny",2,Away
3344,1987-12-06,1987.0,Liverpool,Chelsea,2-1,2,1,1,1,3,1,H,"Dalglish, Kenny",2,Anfield
3345,1987-12-12,1987.0,Southampton,Liverpool,2-2,2,2,1,1,4,0,D,"Dalglish, Kenny",2,Away
3346,1987-12-19,1987.0,Liverpool,Sheffield Wednesday,1-0,1,0,1,1,1,1,H,"Dalglish, Kenny",1,Anfield
3347,1987-12-26,1987.0,Oxford United,Liverpool,0-3,0,3,1,1,3,-3,A,"Dalglish, Kenny",3,Away
3348,1987-12-28,1987.0,Liverpool,Newcastle United,4-0,4,0,1,1,4,4,H,"Dalglish, Kenny",4,Anfield
3349,1988-01-01,1987.0,Liverpool,Coventry City,4-0,4,0,1,1,4,4,H,"Dalglish, Kenny",4,Anfield
3350,1988-01-16,1987.0,Liverpool,Arsenal,2-0,2,0,1,1,2,2,H,"Dalglish, Kenny",2,Anfield
3351,1988-01-23,1987.0,Charlton Athletic,Liverpool,0-2,0,2,1,1,2,-2,A,"Dalglish, Kenny",2,Away
3352,1988-02-06,1987.0,Liverpool,West Ham United,0-0,0,0,1,1,0,0,D,"Dalglish, Kenny",0,Anfield
3353,1988-02-13,1987.0,Watford,Liverpool,1-4,1,4,1,1,5,-3,A,"Dalglish, Kenny",4,Away
3354,1988-02-27,1987.0,Portsmouth,Liverpool,0-2,0,2,1,1,2,-2,A,"Dalglish, Kenny",2,Away
3355,1988-03-05,1987.0,Queens Park Rangers,Liverpool,0-1,0,1,1,1,1,-1,A,"Dalglish, Kenny",1,Away
3356,1988-03-16,1987.0,Derby County,Liverpool,1-1,1,1,1,1,2,0,D,"Dalglish, Kenny",1,Away
3357,1988-03-20,1987.0,Everton,Liverpool,1-0,1,0,1,1,1,1,H,"Dalglish, Kenny",0,Away
3358,1988-03-26,1987.0,Liverpool,Wimbledon,2-1,2,1,1,1,3,1,H,"Dalglish, Kenny",2,Anfield
3359,1988-04-02,1987.0,Nottingham Forest,Liverpool,2-1,2,1,1,1,3,1,H,"Dalglish, Kenny",1,Away
3360,1988-04-04,1987.0,Liverpool,Manchester United,3-3,3,3,1,1,6,0,D,"Dalglish, Kenny",3,Anfield
3361,1988-04-13,1987.0,Liverpool,Nottingham Forest,5-0,5,0,1,1,5,5,H,"Dalglish, Kenny",5,Anfield
3362,1988-04-20,1987.0,Norwich City,Liverpool,0-0,0,0,1,1,0,0,D,"Dalglish, Kenny",0,Away
3363,1988-04-23,1987.0,Liverpool,Tottenham Hotspur,1-0,1,0,1,1,1,1,H,"Dalglish, Kenny",1,Anfield
3364,1988-04-30,1987.0,Chelsea,Liverpool,1-1,1,1,1,1,2,0,D,"Dalglish, Kenny",1,Away
3365,1988-05-02,1987.0,Liverpool,Southampton,1-1,1,1,1,1,2,0,D,"Dalglish, Kenny",1,Anfield
3366,1988-05-07,1987.0,Sheffield Wednesday,Liverpool,1-5,1,5,1,1,6,-4,A,"Dalglish, Kenny",5,Away
3367,1988-05-09,1987.0,Liverpool,Luton Town,1-1,1,1,1,1,2,0,D,"Dalglish, Kenny",1,Anfield
3368,1988-08-27,1988.0,Charlton Athletic,Liverpool,0-3,0,3,1,1,3,-3,A,"Dalglish, Kenny",3,Away
3369,1988-09-03,1988.0,Liverpool,Manchester United,1-0,1,0,1,1,1,1,H,"Dalglish, Kenny",1,Anfield
3370,1988-09-10,1988.0,Aston Villa,Liverpool,1-1,1,1,1,1,2,0,D,"Dalglish, Kenny",1,Away
3371,1988-09-17,1988.0,Liverpool,Tottenham Hotspur,1-1,1,1,1,1,2,0,D,"Dalglish, Kenny",1,Anfield
3372,1988-09-24,1988.0,Southampton,Liverpool,1-3,1,3,1,1,4,-2,A,"Dalglish, Kenny",3,Away
3373,1988-10-01,1988.0,Liverpool,Newcastle United,1-2,1,2,1,1,3,-1,A,"Dalglish, Kenny",1,Anfield
3374,1988-10-08,1988.0,Luton Town,Liverpool,1-0,1,0,1,1,1,1,H,"Dalglish, Kenny",0,Away
3375,1988-10-22,1988.0,Liverpool,Coventry City,0-0,0,0,1,1,0,0,D,"Dalglish, Kenny",0,Anfield
3376,1988-10-26,1988.0,Nottingham Forest,Liverpool,2-1,2,1,1,1,3,1,H,"Dalglish, Kenny",1,Away
3377,1988-10-29,1988.0,West Ham United,Liverpool,0-2,0,2,1,1,2,-2,A,"Dalglish, Kenny",2,Away
3378,1988-11-05,1988.0,Liverpool,Middlesbrough,3-0,3,0,1,1,3,3,H,"Dalglish, Kenny",3,Anfield
3379,1988-11-12,1988.0,Liverpool,Millwall,1-1,1,1,1,1,2,0,D,"Dalglish, Kenny",1,Anfield
3380,1988-11-19,1988.0,Queens Park Rangers,Liverpool,0-1,0,1,1,1,1,-1,A,"Dalglish, Kenny",1,Away
3381,1988-11-26,1988.0,Liverpool,Wimbledon,1-1,1,1,1,1,2,0,D,"Dalglish, Kenny",1,Anfield
3382,1988-12-04,1988.0,Arsenal,Liverpool,1-1,1,1,1,1,2,0,D,"Dalglish, Kenny",1,Away
3383,1988-12-11,1988.0,Liverpool,Everton,1-1,1,1,1,1,2,0,D,"Dalglish, Kenny",1,Anfield
3384,1988-12-17,1988.0,Liverpool,Norwich City,0-1,0,1,1,1,1,-1,A,"Dalglish, Kenny",0,Anfield
3385,1988-12-26,1988.0,Derby County,Liverpool,0-1,0,1,1,1,1,-1,A,"Dalglish, Kenny",1,Away
3386,1989-01-01,1988.0,Manchester United,Liverpool,3-1,3,1,1,1,4,2,H,"Dalglish, Kenny",1,Away
3387,1989-01-03,1988.0,Liverpool,Aston Villa,1-0,1,0,1,1,1,1,H,"Dalglish, Kenny",1,Anfield
3388,1989-01-14,1988.0,Sheffield Wednesday,Liverpool,2-2,2,2,1,1,4,0,D,"Dalglish, Kenny",2,Away
3389,1989-01-21,1988.0,Liverpool,Southampton,2-0,2,0,1,1,2,2,H,"Dalglish, Kenny",2,Anfield
3390,1989-02-04,1988.0,Newcastle United,Liverpool,2-2,2,2,1,1,4,0,D,"Dalglish, Kenny",2,Away
3391,1989-03-01,1988.0,Liverpool,Charlton Athletic,2-0,2,0,1,1,2,2,H,"Dalglish, Kenny",2,Anfield
3392,1989-03-11,1988.0,Middlesbrough,Liverpool,0-4,0,4,1,1,4,-4,A,"Dalglish, Kenny",4,Away
3393,1989-03-14,1988.0,Liverpool,Luton Town,5-0,5,0,1,1,5,5,H,"Dalglish, Kenny",5,Anfield
3394,1989-03-22,1988.0,Coventry City,Liverpool,1-3,1,3,1,1,4,-2,A,"Dalglish, Kenny",3,Away
3395,1989-03-26,1988.0,Tottenham Hotspur,Liverpool,1-2,1,2,1,1,3,-1,A,"Dalglish, Kenny",2,Away
3396,1989-03-29,1988.0,Liverpool,Derby County,1-0,1,0,1,1,1,1,H,"Dalglish, Kenny",1,Anfield
3397,1989-04-01,1988.0,Norwich City,Liverpool,0-1,0,1,1,1,1,-1,A,"Dalglish, Kenny",1,Away
3398,1989-04-08,1988.0,Liverpool,Sheffield Wednesday,5-1,5,1,1,1,6,4,H,"Dalglish, Kenny",5,Anfield
3399,1989-04-11,1988.0,Millwall,Liverpool,1-2,1,2,1,1,3,-1,A,"Dalglish, Kenny",2,Away
3400,1989-05-03,1988.0,Everton,Liverpool,0-0,0,0,1,1,0,0,D,"Dalglish, Kenny",0,Away
3401,1989-05-10,1988.0,Liverpool,Nottingham Forest,1-0,1,0,1,1,1,1,H,"Dalglish, Kenny",1,Anfield
3402,1989-05-13,1988.0,Wimbledon,Liverpool,1-2,1,2,1,1,3,-1,A,"Dalglish, Kenny",2,Away
3403,1989-05-16,1988.0,Liverpool,Queens Park Rangers,2-0,2,0,1,1,2,2,H,"Dalglish, Kenny",2,Anfield
3404,1989-05-23,1988.0,Liverpool,West Ham United,5-1,5,1,1,1,6,4,H,"Dalglish, Kenny",5,Anfield
3405,1989-05-26,1988.0,Liverpool,Arsenal,0-2,0,2,1,1,2,-2,A,"Dalglish, Kenny",0,Anfield
3406,1989-08-19,1989.0,Liverpool,Manchester City,3-1,3,1,1,1,4,2,H,"Dalglish, Kenny",3,Anfield
3407,1989-08-23,1989.0,Aston Villa,Liverpool,1-1,1,1,1,1,2,0,D,"Dalglish, Kenny",1,Away
3408,1989-08-26,1989.0,Luton Town,Liverpool,0-0,0,0,1,1,0,0,D,"Dalglish, Kenny",0,Away
3409,1989-09-09,1989.0,Derby County,Liverpool,0-3,0,3,1,1,3,-3,A,"Dalglish, Kenny",3,Away
3410,1989-09-12,1989.0,Liverpool,Crystal Palace,9-0,9,0,1,1,9,9,H,"Dalglish, Kenny",9,Anfield
3411,1989-09-16,1989.0,Liverpool,Norwich City,0-0,0,0,1,1,0,0,D,"Dalglish, Kenny",0,Anfield
3412,1989-09-23,1989.0,Everton,Liverpool,1-3,1,3,1,1,4,-2,A,"Dalglish, Kenny",3,Away
3413,1989-10-14,1989.0,Wimbledon,Liverpool,1-2,1,2,1,1,3,-1,A,"Dalglish, Kenny",2,Away
3414,1989-10-21,1989.0,Southampton,Liverpool,4-1,4,1,1,1,5,3,H,"Dalglish, Kenny",1,Away
3415,1989-10-29,1989.0,Liverpool,Tottenham Hotspur,1-0,1,0,1,1,1,1,H,"Dalglish, Kenny",1,Anfield
3416,1989-11-04,1989.0,Liverpool,Coventry City,0-1,0,1,1,1,1,-1,A,"Dalglish, Kenny",0,Anfield
3417,1989-11-11,1989.0,Queens Park Rangers,Liverpool,3-2,3,2,1,1,5,1,H,"Dalglish, Kenny",2,Away
3418,1989-11-19,1989.0,Millwall,Liverpool,1-2,1,2,1,1,3,-1,A,"Dalglish, Kenny",2,Away
3419,1989-11-26,1989.0,Liverpool,Arsenal,2-1,2,1,1,1,3,1,H,"Dalglish, Kenny",2,Anfield
3420,1989-11-29,1989.0,Sheffield Wednesday,Liverpool,2-0,2,0,1,1,2,2,H,"Dalglish, Kenny",0,Away
3421,1989-12-02,1989.0,Manchester City,Liverpool,1-4,1,4,1,1,5,-3,A,"Dalglish, Kenny",4,Away
3422,1989-12-09,1989.0,Liverpool,Aston Villa,1-1,1,1,1,1,2,0,D,"Dalglish, Kenny",1,Anfield
3423,1989-12-16,1989.0,Chelsea,Liverpool,2-5,2,5,1,1,7,-3,A,"Dalglish, Kenny",5,Away
3424,1989-12-23,1989.0,Liverpool,Manchester United,0-0,0,0,1,1,0,0,D,"Dalglish, Kenny",0,Anfield
3425,1989-12-26,1989.0,Liverpool,Sheffield Wednesday,2-1,2,1,1,1,3,1,H,"Dalglish, Kenny",2,Anfield
3426,1989-12-30,1989.0,Liverpool,Charlton Athletic,1-0,1,0,1,1,1,1,H,"Dalglish, Kenny",1,Anfield
3427,1990-01-01,1989.0,Nottingham Forest,Liverpool,2-2,2,2,1,1,4,0,D,"Dalglish, Kenny",2,Away
3428,1990-01-13,1989.0,Liverpool,Luton Town,2-2,2,2,1,1,4,0,D,"Dalglish, Kenny",2,Anfield
3429,1990-01-20,1989.0,Crystal Palace,Liverpool,0-2,0,2,1,1,2,-2,A,"Dalglish, Kenny",2,Away
3430,1990-02-03,1989.0,Liverpool,Everton,2-1,2,1,1,1,3,1,H,"Dalglish, Kenny",2,Anfield
3431,1990-02-10,1989.0,Norwich City,Liverpool,0-0,0,0,1,1,0,0,D,"Dalglish, Kenny",0,Away
3432,1990-03-03,1989.0,Liverpool,Millwall,1-0,1,0,1,1,1,1,H,"Dalglish, Kenny",1,Anfield
3433,1990-03-18,1989.0,Manchester United,Liverpool,1-2,1,2,1,1,3,-1,A,"Dalglish, Kenny",2,Away
3434,1990-03-21,1989.0,Tottenham Hotspur,Liverpool,1-0,1,0,1,1,1,1,H,"Dalglish, Kenny",0,Away
3435,1990-03-31,1989.0,Liverpool,Southampton,3-2,3,2,1,1,5,1,H,"Dalglish, Kenny",3,Anfield
3436,1990-04-03,1989.0,Liverpool,Wimbledon,2-1,2,1,1,1,3,1,H,"Dalglish, Kenny",2,Anfield
3437,1990-04-11,1989.0,Charlton Athletic,Liverpool,0-4,0,4,1,1,4,-4,A,"Dalglish, Kenny",4,Away
3438,1990-04-14,1989.0,Liverpool,Nottingham Forest,2-2,2,2,1,1,4,0,D,"Dalglish, Kenny",2,Anfield
3439,1990-04-18,1989.0,Arsenal,Liverpool,1-1,1,1,1,1,2,0,D,"Dalglish, Kenny",1,Away
3440,1990-04-21,1989.0,Liverpool,Chelsea,4-1,4,1,1,1,5,3,H,"Dalglish, Kenny",4,Anfield
3441,1990-04-28,1989.0,Liverpool,Queens Park Rangers,2-1,2,1,1,1,3,1,H,"Dalglish, Kenny",2,Anfield
3442,1990-05-01,1989.0,Liverpool,Derby County,1-0,1,0,1,1,1,1,H,"Dalglish, Kenny",1,Anfield
3443,1990-05-05,1989.0,Coventry City,Liverpool,1-6,1,6,1,1,7,-5,A,"Dalglish, Kenny",6,Away
3444,1990-08-25,1990.0,Sheffield United,Liverpool,1-3,1,3,1,1,4,-2,A,"Dalglish, Kenny",3,Away
3445,1990-08-28,1990.0,Liverpool,Nottingham Forest,2-0,2,0,1,1,2,2,H,"Dalglish, Kenny",2,Anfield
3446,1990-09-01,1990.0,Liverpool,Aston Villa,2-1,2,1,1,1,3,1,H,"Dalglish, Kenny",2,Anfield
3447,1990-09-08,1990.0,Wimbledon,Liverpool,1-2,1,2,1,1,3,-1,A,"Dalglish, Kenny",2,Away
3448,1990-09-16,1990.0,Liverpool,Manchester United,4-0,4,0,1,1,4,4,H,"Dalglish, Kenny",4,Anfield
3449,1990-09-22,1990.0,Everton,Liverpool,2-3,2,3,1,1,5,-1,A,"Dalglish, Kenny",3,Away
3450,1990-09-29,1990.0,Sunderland,Liverpool,0-1,0,1,1,1,1,-1,A,"Dalglish, Kenny",1,Away
3451,1990-10-06,1990.0,Liverpool,Derby County,2-0,2,0,1,1,2,2,H,"Dalglish, Kenny",2,Anfield
3452,1990-10-20,1990.0,Norwich City,Liverpool,1-1,1,1,1,1,2,0,D,"Dalglish, Kenny",1,Away
3453,1990-10-27,1990.0,Liverpool,Chelsea,2-0,2,0,1,1,2,2,H,"Dalglish, Kenny",2,Anfield
3454,1990-11-04,1990.0,Tottenham Hotspur,Liverpool,1-3,1,3,1,1,4,-2,A,"Dalglish, Kenny",3,Away
3455,1990-11-10,1990.0,Liverpool,Luton Town,4-0,4,0,1,1,4,4,H,"Dalglish, Kenny",4,Anfield
3456,1990-11-17,1990.0,Coventry City,Liverpool,0-1,0,1,1,1,1,-1,A,"Dalglish, Kenny",1,Away
3457,1990-11-24,1990.0,Liverpool,Manchester City,2-2,2,2,1,1,4,0,D,"Dalglish, Kenny",2,Anfield
3458,1990-12-02,1990.0,Arsenal,Liverpool,3-0,3,0,1,1,3,3,H,"Dalglish, Kenny",0,Away
3459,1990-12-15,1990.0,Liverpool,Sheffield United,2-0,2,0,1,1,2,2,H,"Dalglish, Kenny",2,Anfield
3460,1990-12-22,1990.0,Liverpool,Southampton,3-2,3,2,1,1,5,1,H,"Dalglish, Kenny",3,Anfield
3461,1990-12-26,1990.0,Queens Park Rangers,Liverpool,1-1,1,1,1,1,2,0,D,"Dalglish, Kenny",1,Away
3462,1990-12-30,1990.0,Crystal Palace,Liverpool,1-0,1,0,1,1,1,1,H,"Dalglish, Kenny",0,Away
3463,1991-01-01,1990.0,Liverpool,Leeds United,3-0,3,0,1,1,3,3,H,"Dalglish, Kenny",3,Anfield
3464,1991-01-12,1990.0,Aston Villa,Liverpool,0-0,0,0,1,1,0,0,D,"Dalglish, Kenny",0,Away
3465,1991-01-19,1990.0,Liverpool,Wimbledon,1-1,1,1,1,1,2,0,D,"Dalglish, Kenny",1,Anfield
3466,1991-02-03,1990.0,Manchester United,Liverpool,1-1,1,1,1,1,2,0,D,"Dalglish, Kenny",1,Away
3467,1991-02-09,1990.0,Liverpool,Everton,3-1,3,1,1,1,4,2,H,"Dalglish, Kenny",3,Anfield
3468,1991-02-23,1990.0,Luton Town,Liverpool,3-1,3,1,1,1,4,2,H,"Moran*, Ronnie",1,Away
3469,1991-03-03,1990.0,Liverpool,Arsenal,0-1,0,1,1,1,1,-1,A,"Moran*, Ronnie",0,Anfield
3470,1991-03-09,1990.0,Manchester City,Liverpool,0-3,0,3,1,1,3,-3,A,"Moran*, Ronnie",3,Away
3471,1991-03-16,1990.0,Liverpool,Sunderland,2-1,2,1,1,1,3,1,H,"Moran*, Ronnie",2,Anfield
3472,1991-03-23,1990.0,Derby County,Liverpool,1-7,1,7,1,1,8,-6,A,"Moran*, Ronnie",7,Away
3473,1991-03-30,1990.0,Liverpool,Queens Park Rangers,1-3,1,3,1,1,4,-2,A,"Moran*, Ronnie",1,Anfield
3474,1991-04-01,1990.0,Southampton,Liverpool,1-0,1,0,1,1,1,1,H,"Moran*, Ronnie",0,Away
3475,1991-04-09,1990.0,Liverpool,Coventry City,1-1,1,1,1,1,2,0,D,"Moran*, Ronnie",1,Anfield
3476,1991-04-13,1990.0,Leeds United,Liverpool,4-5,4,5,1,1,9,-1,A,"Moran*, Ronnie",5,Away
3477,1991-04-20,1990.0,Liverpool,Norwich City,3-0,3,0,1,1,3,3,H,"Souness, Graeme",3,Anfield
3478,1991-04-23,1990.0,Liverpool,Crystal Palace,3-0,3,0,1,1,3,3,H,"Souness, Graeme",3,Anfield
3479,1991-05-04,1990.0,Chelsea,Liverpool,4-2,4,2,1,1,6,2,H,"Souness, Graeme",2,Away
3480,1991-05-06,1990.0,Nottingham Forest,Liverpool,2-1,2,1,1,1,3,1,H,"Souness, Graeme",1,Away
3481,1991-05-11,1990.0,Liverpool,Tottenham Hotspur,2-0,2,0,1,1,2,2,H,"Souness, Graeme",2,Anfield
3482,1991-08-17,1991.0,Liverpool,Oldham Athletic,2-1,2,1,1,1,3,1,H,"Souness, Graeme",2,Anfield
3483,1991-08-21,1991.0,Manchester City,Liverpool,2-1,2,1,1,1,3,1,H,"Souness, Graeme",1,Away
3484,1991-08-24,1991.0,Luton Town,Liverpool,0-0,0,0,1,1,0,0,D,"Souness, Graeme",0,Away
3485,1991-08-27,1991.0,Liverpool,Queens Park Rangers,1-0,1,0,1,1,1,1,H,"Souness, Graeme",1,Anfield
3486,1991-08-31,1991.0,Liverpool,Everton,3-1,3,1,1,1,4,2,H,"Souness, Graeme",3,Anfield
3487,1991-09-07,1991.0,Notts County,Liverpool,1-2,1,2,1,1,3,-1,A,"Souness, Graeme",2,Away
3488,1991-09-14,1991.0,Liverpool,Aston Villa,1-1,1,1,1,1,2,0,D,"Souness, Graeme",1,Anfield
3489,1991-09-21,1991.0,Leeds United,Liverpool,1-0,1,0,1,1,1,1,H,"Souness, Graeme",0,Away
3490,1991-09-28,1991.0,Liverpool,Sheffield Wednesday,1-1,1,1,1,1,2,0,D,"Souness, Graeme",1,Anfield
3491,1991-10-06,1991.0,Manchester United,Liverpool,0-0,0,0,1,1,0,0,D,"Souness, Graeme",0,Away
3492,1991-10-19,1991.0,Chelsea,Liverpool,2-2,2,2,1,1,4,0,D,"Souness, Graeme",2,Away
3493,1991-10-26,1991.0,Liverpool,Coventry City,1-0,1,0,1,1,1,1,H,"Souness, Graeme",1,Anfield
3494,1991-11-02,1991.0,Liverpool,Crystal Palace,1-2,1,2,1,1,3,-1,A,"Souness, Graeme",1,Anfield
3495,1991-11-17,1991.0,West Ham United,Liverpool,0-0,0,0,1,1,0,0,D,"Souness, Graeme",0,Away
3496,1991-11-23,1991.0,Wimbledon,Liverpool,0-0,0,0,1,1,0,0,D,"Souness, Graeme",0,Away
3497,1991-11-30,1991.0,Liverpool,Norwich City,2-1,2,1,1,1,3,1,H,"Souness, Graeme",2,Anfield
3498,1991-12-07,1991.0,Southampton,Liverpool,1-1,1,1,1,1,2,0,D,"Souness, Graeme",1,Away
3499,1991-12-14,1991.0,Liverpool,Nottingham Forest,2-0,2,0,1,1,2,2,H,"Souness, Graeme",2,Anfield
3500,1991-12-18,1991.0,Tottenham Hotspur,Liverpool,1-2,1,2,1,1,3,-1,A,"Souness, Graeme",2,Away
3501,1991-12-21,1991.0,Liverpool,Manchester City,2-2,2,2,1,1,4,0,D,"Souness, Graeme",2,Anfield
3502,1991-12-26,1991.0,Queens Park Rangers,Liverpool,0-0,0,0,1,1,0,0,D,"Souness, Graeme",0,Away
3503,1991-12-28,1991.0,Everton,Liverpool,1-1,1,1,1,1,2,0,D,"Souness, Graeme",1,Away
3504,1992-01-01,1991.0,Liverpool,Sheffield United,2-1,2,1,1,1,3,1,H,"Souness, Graeme",2,Anfield
3505,1992-01-11,1991.0,Liverpool,Luton Town,2-1,2,1,1,1,3,1,H,"Souness, Graeme",2,Anfield
3506,1992-01-18,1991.0,Oldham Athletic,Liverpool,2-3,2,3,1,1,5,-1,A,"Souness, Graeme",3,Away
3507,1992-01-29,1991.0,Liverpool,Arsenal,2-0,2,0,1,1,2,2,H,"Souness, Graeme",2,Anfield
3508,1992-02-01,1991.0,Liverpool,Chelsea,1-2,1,2,1,1,3,-1,A,"Souness, Graeme",1,Anfield
3509,1992-02-08,1991.0,Coventry City,Liverpool,0-0,0,0,1,1,0,0,D,"Souness, Graeme",0,Away
3510,1992-02-22,1991.0,Norwich City,Liverpool,3-0,3,0,1,1,3,3,H,"Souness, Graeme",0,Away
3511,1992-02-29,1991.0,Liverpool,Southampton,0-0,0,0,1,1,0,0,D,"Souness, Graeme",0,Anfield
3512,1992-03-11,1991.0,Liverpool,West Ham United,1-0,1,0,1,1,1,1,H,"Souness, Graeme",1,Anfield
3513,1992-03-14,1991.0,Crystal Palace,Liverpool,1-0,1,0,1,1,1,1,H,"Souness, Graeme",0,Away
3514,1992-03-21,1991.0,Liverpool,Tottenham Hotspur,2-1,2,1,1,1,3,1,H,"Souness, Graeme",2,Anfield
3515,1992-03-28,1991.0,Sheffield United,Liverpool,2-0,2,0,1,1,2,2,H,"Souness, Graeme",0,Away
3516,1992-03-31,1991.0,Liverpool,Notts County,4-0,4,0,1,1,4,4,H,"Souness, Graeme",4,Anfield
3517,1992-04-08,1991.0,Liverpool,Wimbledon,2-3,2,3,1,1,5,-1,A,"Souness, Graeme",2,Anfield
3518,1992-04-11,1991.0,Aston Villa,Liverpool,1-0,1,0,1,1,1,1,H,"Souness, Graeme",0,Away
3519,1992-04-18,1991.0,Liverpool,Leeds United,0-0,0,0,1,1,0,0,D,"Souness, Graeme",0,Anfield
3520,1992-04-20,1991.0,Arsenal,Liverpool,4-0,4,0,1,1,4,4,H,"Souness, Graeme",0,Away
3521,1992-04-22,1991.0,Nottingham Forest,Liverpool,1-1,1,1,1,1,2,0,D,"Souness, Graeme",1,Away
3522,1992-04-26,1991.0,Liverpool,Manchester United,2-0,2,0,1,1,2,2,H,"Souness, Graeme",2,Anfield
3523,1992-05-02,1991.0,Sheffield Wednesday,Liverpool,0-0,0,0,1,1,0,0,D,"Souness, Graeme",0,Away
3524,1992-08-16,1992.0,Nottingham Forest,Liverpool,1-0,1,0,1,1,1,1,H,"Souness, Graeme",0,Away
3525,1992-08-19,1992.0,Liverpool,Sheffield United,2-1,2,1,1,1,3,1,H,"Souness, Graeme",2,Anfield
3526,1992-08-23,1992.0,Liverpool,Arsenal,0-2,0,2,1,1,2,-2,A,"Souness, Graeme",0,Anfield
3527,1992-08-25,1992.0,Ipswich Town,Liverpool,2-2,2,2,1,1,4,0,D,"Souness, Graeme",2,Away
3528,1992-08-29,1992.0,Leeds United,Liverpool,2-2,2,2,1,1,4,0,D,"Souness, Graeme",2,Away
3529,1992-09-01,1992.0,Liverpool,Southampton,1-1,1,1,1,1,2,0,D,"Souness, Graeme",1,Anfield
3530,1992-09-05,1992.0,Liverpool,Chelsea,2-1,2,1,1,1,3,1,H,"Souness, Graeme",2,Anfield
3531,1992-09-12,1992.0,Sheffield United,Liverpool,1-0,1,0,1,1,1,1,H,"Souness, Graeme",0,Away
3532,1992-09-19,1992.0,Aston Villa,Liverpool,4-2,4,2,1,1,6,2,H,"Souness, Graeme",2,Away
3533,1992-09-26,1992.0,Liverpool,Wimbledon,2-3,2,3,1,1,5,-1,A,"Souness, Graeme",2,Anfield
3534,1992-10-03,1992.0,Liverpool,Sheffield Wednesday,1-0,1,0,1,1,1,1,H,"Souness, Graeme",1,Anfield
3535,1992-10-18,1992.0,Manchester United,Liverpool,2-2,2,2,1,1,4,0,D,"Souness, Graeme",2,Away
3536,1992-10-25,1992.0,Liverpool,Norwich City,4-1,4,1,1,1,5,3,H,"Souness, Graeme",4,Anfield
3537,1992-10-31,1992.0,Tottenham Hotspur,Liverpool,2-0,2,0,1,1,2,2,H,"Souness, Graeme",0,Away
3538,1992-11-07,1992.0,Liverpool,Middlesbrough,4-1,4,1,1,1,5,3,H,"Souness, Graeme",4,Anfield
3539,1992-11-23,1992.0,Queens Park Rangers,Liverpool,0-1,0,1,1,1,1,-1,A,"Souness, Graeme",1,Away
3540,1992-11-28,1992.0,Liverpool,Crystal Palace,5-0,5,0,1,1,5,5,H,"Souness, Graeme",5,Anfield
3541,1992-12-07,1992.0,Everton,Liverpool,2-1,2,1,1,1,3,1,H,"Souness, Graeme",1,Away
3542,1992-12-13,1992.0,Liverpool,Blackburn Rovers,2-1,2,1,1,1,3,1,H,"Souness, Graeme",2,Anfield
3543,1992-12-19,1992.0,Coventry City,Liverpool,5-1,5,1,1,1,6,4,H,"Souness, Graeme",1,Away
3544,1992-12-28,1992.0,Liverpool,Manchester City,1-1,1,1,1,1,2,0,D,"Souness, Graeme",1,Anfield
3545,1993-01-09,1992.0,Liverpool,Aston Villa,1-2,1,2,1,1,3,-1,A,"Souness, Graeme",1,Anfield
3546,1993-01-16,1992.0,Wimbledon,Liverpool,2-0,2,0,1,1,2,2,H,"Souness, Graeme",0,Away
3547,1993-01-31,1992.0,Arsenal,Liverpool,0-1,0,1,1,1,1,-1,A,"Souness, Graeme",1,Away
3548,1993-02-06,1992.0,Liverpool,Nottingham Forest,0-0,0,0,1,1,0,0,D,"Souness, Graeme",0,Anfield
3549,1993-02-10,1992.0,Chelsea,Liverpool,0-0,0,0,1,1,0,0,D,"Souness, Graeme",0,Away
3550,1993-02-13,1992.0,Southampton,Liverpool,2-1,2,1,1,1,3,1,H,"Souness, Graeme",1,Away
3551,1993-02-20,1992.0,Liverpool,Ipswich Town,0-0,0,0,1,1,0,0,D,"Souness, Graeme",0,Anfield
3552,1993-02-27,1992.0,Sheffield Wednesday,Liverpool,1-1,1,1,1,1,2,0,D,"Souness, Graeme",1,Away
3553,1993-03-06,1992.0,Liverpool,Manchester United,1-2,1,2,1,1,3,-1,A,"Souness, Graeme",1,Anfield
3554,1993-03-10,1992.0,Liverpool,Queens Park Rangers,1-0,1,0,1,1,1,1,H,"Souness, Graeme",1,Anfield
3555,1993-03-13,1992.0,Middlesbrough,Liverpool,1-2,1,2,1,1,3,-1,A,"Souness, Graeme",2,Away
3556,1993-03-20,1992.0,Liverpool,Everton,1-0,1,0,1,1,1,1,H,"Souness, Graeme",1,Anfield
3557,1993-03-23,1992.0,Crystal Palace,Liverpool,1-1,1,1,1,1,2,0,D,"Souness, Graeme",1,Away
3558,1993-04-03,1992.0,Blackburn Rovers,Liverpool,4-1,4,1,1,1,5,3,H,"Souness, Graeme",1,Away
3559,1993-04-10,1992.0,Liverpool,Oldham Athletic,1-0,1,0,1,1,1,1,H,"Souness, Graeme",1,Anfield
3560,1993-04-12,1992.0,Manchester City,Liverpool,1-1,1,1,1,1,2,0,D,"Souness, Graeme",1,Away
3561,1993-04-17,1992.0,Liverpool,Coventry City,4-0,4,0,1,1,4,4,H,"Souness, Graeme",4,Anfield
3562,1993-04-21,1992.0,Liverpool,Leeds United,2-0,2,0,1,1,2,2,H,"Souness, Graeme",2,Anfield
3563,1993-05-01,1992.0,Norwich City,Liverpool,1-0,1,0,1,1,1,1,H,"Souness, Graeme",0,Away
3564,1993-05-05,1992.0,Oldham Athletic,Liverpool,3-2,3,2,1,1,5,1,H,"Souness, Graeme",2,Away
3565,1993-05-08,1992.0,Liverpool,Tottenham Hotspur,6-2,6,2,1,1,8,4,H,"Souness, Graeme",6,Anfield
3566,1993-08-14,1993.0,Liverpool,Sheffield Wednesday,2-0,2,0,1,1,2,2,H,"Souness, Graeme",2,Anfield
3567,1993-08-18,1993.0,Queens Park Rangers,Liverpool,1-3,1,3,1,1,4,-2,A,"Souness, Graeme",3,Away
3568,1993-08-22,1993.0,Swindon Town,Liverpool,0-5,0,5,1,1,5,-5,A,"Souness, Graeme",5,Away
3569,1993-08-25,1993.0,Liverpool,Tottenham Hotspur,1-2,1,2,1,1,3,-1,A,"Souness, Graeme",1,Anfield
3570,1993-08-28,1993.0,Liverpool,Leeds United,2-0,2,0,1,1,2,2,H,"Souness, Graeme",2,Anfield
3571,1993-09-01,1993.0,Coventry City,Liverpool,1-0,1,0,1,1,1,1,H,"Souness, Graeme",0,Away
3572,1993-09-12,1993.0,Liverpool,Blackburn Rovers,0-1,0,1,1,1,1,-1,A,"Souness, Graeme",0,Anfield
3573,1993-09-18,1993.0,Everton,Liverpool,2-0,2,0,1,1,2,2,H,"Souness, Graeme",0,Away
3574,1993-09-25,1993.0,Chelsea,Liverpool,1-0,1,0,1,1,1,1,H,"Souness, Graeme",0,Away
3575,1993-10-02,1993.0,Liverpool,Arsenal,0-0,0,0,1,1,0,0,D,"Souness, Graeme",0,Anfield
3576,1993-10-16,1993.0,Liverpool,Oldham Athletic,2-1,2,1,1,1,3,1,H,"Souness, Graeme",2,Anfield
3577,1993-10-23,1993.0,Manchester City,Liverpool,1-1,1,1,1,1,2,0,D,"Souness, Graeme",1,Away
3578,1993-10-30,1993.0,Liverpool,Southampton,4-2,4,2,1,1,6,2,H,"Souness, Graeme",4,Anfield
3579,1993-11-06,1993.0,Liverpool,West Ham United,2-0,2,0,1,1,2,2,H,"Souness, Graeme",2,Anfield
3580,1993-11-21,1993.0,Newcastle United,Liverpool,3-0,3,0,1,1,3,3,H,"Souness, Graeme",0,Away
3581,1993-11-28,1993.0,Liverpool,Aston Villa,2-1,2,1,1,1,3,1,H,"Souness, Graeme",2,Anfield
3582,1993-12-04,1993.0,Sheffield Wednesday,Liverpool,3-1,3,1,1,1,4,2,H,"Souness, Graeme",1,Away
3583,1993-12-08,1993.0,Liverpool,Queens Park Rangers,3-2,3,2,1,1,5,1,H,"Souness, Graeme",3,Anfield
3584,1993-12-11,1993.0,Liverpool,Swindon Town,2-2,2,2,1,1,4,0,D,"Souness, Graeme",2,Anfield
3585,1993-12-18,1993.0,Tottenham Hotspur,Liverpool,3-3,3,3,1,1,6,0,D,"Souness, Graeme",3,Away
3586,1993-12-26,1993.0,Sheffield United,Liverpool,0-0,0,0,1,1,0,0,D,"Souness, Graeme",0,Away
3587,1993-12-28,1993.0,Liverpool,Wimbledon,1-1,1,1,1,1,2,0,D,"Souness, Graeme",1,Anfield
3588,1994-01-01,1993.0,Ipswich Town,Liverpool,1-2,1,2,1,1,3,-1,A,"Souness, Graeme",2,Away
3589,1994-01-04,1993.0,Liverpool,Manchester United,3-3,3,3,1,1,6,0,D,"Souness, Graeme",3,Anfield
3590,1994-01-15,1993.0,Oldham Athletic,Liverpool,0-3,0,3,1,1,3,-3,A,"Souness, Graeme",3,Away
3591,1994-01-22,1993.0,Liverpool,Manchester City,2-1,2,1,1,1,3,1,H,"Souness, Graeme",2,Anfield
3592,1994-02-05,1993.0,Norwich City,Liverpool,2-2,2,2,1,1,4,0,D,"Evans, Roy",2,Away
3593,1994-02-14,1993.0,Southampton,Liverpool,4-2,4,2,1,1,6,2,H,"Evans, Roy",2,Away
3594,1994-02-19,1993.0,Leeds United,Liverpool,2-0,2,0,1,1,2,2,H,"Evans, Roy",0,Away
3595,1994-02-26,1993.0,Liverpool,Coventry City,1-0,1,0,1,1,1,1,H,"Evans, Roy",1,Anfield
3596,1994-03-05,1993.0,Blackburn Rovers,Liverpool,2-0,2,0,1,1,2,2,H,"Evans, Roy",0,Away
3597,1994-03-13,1993.0,Liverpool,Everton,2-1,2,1,1,1,3,1,H,"Evans, Roy",2,Anfield
3598,1994-03-19,1993.0,Liverpool,Chelsea,2-1,2,1,1,1,3,1,H,"Evans, Roy",2,Anfield
3599,1994-03-26,1993.0,Arsenal,Liverpool,1-0,1,0,1,1,1,1,H,"Evans, Roy",0,Away
3600,1994-03-30,1993.0,Manchester United,Liverpool,1-0,1,0,1,1,1,1,H,"Evans, Roy",0,Away
3601,1994-04-02,1993.0,Liverpool,Sheffield United,1-2,1,2,1,1,3,-1,A,"Evans, Roy",1,Anfield
3602,1994-04-04,1993.0,Wimbledon,Liverpool,1-1,1,1,1,1,2,0,D,"Evans, Roy",1,Away
3603,1994-04-09,1993.0,Liverpool,Ipswich Town,1-0,1,0,1,1,1,1,H,"Evans, Roy",1,Anfield
3604,1994-04-16,1993.0,Liverpool,Newcastle United,0-2,0,2,1,1,2,-2,A,"Evans, Roy",0,Anfield
3605,1994-04-23,1993.0,West Ham United,Liverpool,1-2,1,2,1,1,3,-1,A,"Evans, Roy",2,Away
3606,1994-04-30,1993.0,Liverpool,Norwich City,0-1,0,1,1,1,1,-1,A,"Evans, Roy",0,Anfield
3607,1994-05-07,1993.0,Aston Villa,Liverpool,2-1,2,1,1,1,3,1,H,"Evans, Roy",1,Away
3608,1994-08-20,1994.0,Crystal Palace,Liverpool,1-6,1,6,1,1,7,-5,A,"Evans, Roy",6,Away
3609,1994-08-28,1994.0,Liverpool,Arsenal,3-0,3,0,1,1,3,3,H,"Evans, Roy",3,Anfield
3610,1994-08-31,1994.0,Southampton,Liverpool,0-2,0,2,1,1,2,-2,A,"Evans, Roy",2,Away
3611,1994-09-10,1994.0,Liverpool,West Ham United,0-0,0,0,1,1,0,0,D,"Evans, Roy",0,Anfield
3612,1994-09-17,1994.0,Manchester United,Liverpool,2-0,2,0,1,1,2,2,H,"Evans, Roy",0,Away
3613,1994-09-24,1994.0,Newcastle United,Liverpool,1-1,1,1,1,1,2,0,D,"Evans, Roy",1,Away
3614,1994-10-01,1994.0,Liverpool,Sheffield Wednesday,4-1,4,1,1,1,5,3,H,"Evans, Roy",4,Anfield
3615,1994-10-08,1994.0,Liverpool,Aston Villa,3-2,3,2,1,1,5,1,H,"Evans, Roy",3,Anfield
3616,1994-10-15,1994.0,Blackburn Rovers,Liverpool,3-2,3,2,1,1,5,1,H,"Evans, Roy",2,Away
3617,1994-10-22,1994.0,Liverpool,Wimbledon,3-0,3,0,1,1,3,3,H,"Evans, Roy",3,Anfield
3618,1994-10-29,1994.0,Ipswich Town,Liverpool,1-3,1,3,1,1,4,-2,A,"Evans, Roy",3,Away
3619,1994-10-31,1994.0,Queens Park Rangers,Liverpool,2-1,2,1,1,1,3,1,H,"Evans, Roy",1,Away
3620,1994-11-05,1994.0,Liverpool,Nottingham Forest,1-0,1,0,1,1,1,1,H,"Evans, Roy",1,Anfield
3621,1994-11-09,1994.0,Liverpool,Chelsea,3-1,3,1,1,1,4,2,H,"Evans, Roy",3,Anfield
3622,1994-11-21,1994.0,Everton,Liverpool,2-0,2,0,1,1,2,2,H,"Evans, Roy",0,Away
3623,1994-11-26,1994.0,Liverpool,Tottenham Hotspur,1-1,1,1,1,1,2,0,D,"Evans, Roy",1,Anfield
3624,1994-12-03,1994.0,Coventry City,Liverpool,1-1,1,1,1,1,2,0,D,"Evans, Roy",1,Away
3625,1994-12-11,1994.0,Liverpool,Crystal Palace,0-0,0,0,1,1,0,0,D,"Evans, Roy",0,Anfield
3626,1994-12-18,1994.0,Chelsea,Liverpool,0-0,0,0,1,1,0,0,D,"Evans, Roy",0,Away
3627,1994-12-26,1994.0,Leicester City,Liverpool,1-2,1,2,1,1,3,-1,A,"Evans, Roy",2,Away
3628,1994-12-28,1994.0,Liverpool,Manchester City,2-0,2,0,1,1,2,2,H,"Evans, Roy",2,Anfield
3629,1994-12-31,1994.0,Leeds United,Liverpool,0-2,0,2,1,1,2,-2,A,"Evans, Roy",2,Away
3630,1995-01-02,1994.0,Liverpool,Norwich City,4-0,4,0,1,1,4,4,H,"Evans, Roy",4,Anfield
3631,1995-01-14,1994.0,Liverpool,Ipswich Town,0-1,0,1,1,1,1,-1,A,"Evans, Roy",0,Anfield
3632,1995-01-24,1994.0,Liverpool,Everton,0-0,0,0,1,1,0,0,D,"Evans, Roy",0,Anfield
3633,1995-02-04,1994.0,Nottingham Forest,Liverpool,1-1,1,1,1,1,2,0,D,"Evans, Roy",1,Away
3634,1995-02-11,1994.0,Liverpool,Queens Park Rangers,1-1,1,1,1,1,2,0,D,"Evans, Roy",1,Anfield
3635,1995-02-25,1994.0,Sheffield Wednesday,Liverpool,1-2,1,2,1,1,3,-1,A,"Evans, Roy",2,Away
3636,1995-03-04,1994.0,Liverpool,Newcastle United,2-0,2,0,1,1,2,2,H,"Evans, Roy",2,Anfield
3637,1995-03-14,1994.0,Liverpool,Coventry City,2-3,2,3,1,1,5,-1,A,"Evans, Roy",2,Anfield
3638,1995-03-19,1994.0,Liverpool,Manchester United,2-0,2,0,1,1,2,2,H,"Evans, Roy",2,Anfield
3639,1995-03-22,1994.0,Tottenham Hotspur,Liverpool,0-0,0,0,1,1,0,0,D,"Evans, Roy",0,Away
3640,1995-04-05,1994.0,Liverpool,Southampton,3-1,3,1,1,1,4,2,H,"Evans, Roy",3,Anfield
3641,1995-04-09,1994.0,Liverpool,Leeds United,0-1,0,1,1,1,1,-1,A,"Evans, Roy",0,Anfield
3642,1995-04-12,1994.0,Arsenal,Liverpool,0-1,0,1,1,1,1,-1,A,"Evans, Roy",1,Away
3643,1995-04-14,1994.0,Manchester City,Liverpool,2-1,2,1,1,1,3,1,H,"Evans, Roy",1,Away
3644,1995-04-17,1994.0,Liverpool,Leicester City,2-0,2,0,1,1,2,2,H,"Evans, Roy",2,Anfield
3645,1995-04-29,1994.0,Norwich City,Liverpool,1-2,1,2,1,1,3,-1,A,"Evans, Roy",2,Away
3646,1995-05-02,1994.0,Wimbledon,Liverpool,0-0,0,0,1,1,0,0,D,"Evans, Roy",0,Away
3647,1995-05-06,1994.0,Aston Villa,Liverpool,2-0,2,0,1,1,2,2,H,"Evans, Roy",0,Away
3648,1995-05-10,1994.0,West Ham United,Liverpool,3-0,3,0,1,1,3,3,H,"Evans, Roy",0,Away
3649,1995-05-14,1994.0,Liverpool,Blackburn Rovers,2-1,2,1,1,1,3,1,H,"Evans, Roy",2,Anfield
3650,1995-08-19,1995.0,Liverpool,Sheffield Wednesday,1-0,1,0,1,1,1,1,H,"Evans, Roy",1,Anfield
3651,1995-08-21,1995.0,Leeds United,Liverpool,1-0,1,0,1,1,1,1,H,"Evans, Roy",0,Away
3652,1995-08-26,1995.0,Tottenham Hotspur,Liverpool,1-3,1,3,1,1,4,-2,A,"Evans, Roy",3,Away
3653,1995-08-30,1995.0,Liverpool,Queens Park Rangers,1-0,1,0,1,1,1,1,H,"Evans, Roy",1,Anfield
3654,1995-09-09,1995.0,Wimbledon,Liverpool,1-0,1,0,1,1,1,1,H,"Evans, Roy",0,Away
3655,1995-09-16,1995.0,Liverpool,Blackburn Rovers,3-0,3,0,1,1,3,3,H,"Evans, Roy",3,Anfield
3656,1995-09-23,1995.0,Liverpool,Bolton Wanderers,5-2,5,2,1,1,7,3,H,"Evans, Roy",5,Anfield
3657,1995-10-01,1995.0,Manchester United,Liverpool,2-2,2,2,1,1,4,0,D,"Evans, Roy",2,Away
3658,1995-10-14,1995.0,Liverpool,Coventry City,0-0,0,0,1,1,0,0,D,"Evans, Roy",0,Anfield
3659,1995-10-22,1995.0,Southampton,Liverpool,1-3,1,3,1,1,4,-2,A,"Evans, Roy",3,Away
3660,1995-10-28,1995.0,Liverpool,Manchester City,6-0,6,0,1,1,6,6,H,"Evans, Roy",6,Anfield
3661,1995-11-04,1995.0,Newcastle United,Liverpool,2-1,2,1,1,1,3,1,H,"Evans, Roy",1,Away
3662,1995-11-18,1995.0,Liverpool,Everton,1-2,1,2,1,1,3,-1,A,"Evans, Roy",1,Anfield
3663,1995-11-22,1995.0,West Ham United,Liverpool,0-0,0,0,1,1,0,0,D,"Evans, Roy",0,Away
3664,1995-11-25,1995.0,Middlesbrough,Liverpool,2-1,2,1,1,1,3,1,H,"Evans, Roy",1,Away
3665,1995-12-02,1995.0,Liverpool,Southampton,1-1,1,1,1,1,2,0,D,"Evans, Roy",1,Anfield
3666,1995-12-09,1995.0,Bolton Wanderers,Liverpool,0-1,0,1,1,1,1,-1,A,"Evans, Roy",1,Away
3667,1995-12-17,1995.0,Liverpool,Manchester United,2-0,2,0,1,1,2,2,H,"Evans, Roy",2,Anfield
3668,1995-12-23,1995.0,Liverpool,Arsenal,3-1,3,1,1,1,4,2,H,"Evans, Roy",3,Anfield
3669,1995-12-30,1995.0,Chelsea,Liverpool,2-2,2,2,1,1,4,0,D,"Evans, Roy",2,Away
3670,1996-01-01,1995.0,Liverpool,Nottingham Forest,4-2,4,2,1,1,6,2,H,"Evans, Roy",4,Anfield
3671,1996-01-13,1995.0,Sheffield Wednesday,Liverpool,1-1,1,1,1,1,2,0,D,"Evans, Roy",1,Away
3672,1996-01-20,1995.0,Liverpool,Leeds United,5-0,5,0,1,1,5,5,H,"Evans, Roy",5,Anfield
3673,1996-01-31,1995.0,Aston Villa,Liverpool,0-2,0,2,1,1,2,-2,A,"Evans, Roy",2,Away
3674,1996-02-03,1995.0,Liverpool,Tottenham Hotspur,0-0,0,0,1,1,0,0,D,"Evans, Roy",0,Anfield
3675,1996-02-11,1995.0,Queens Park Rangers,Liverpool,1-2,1,2,1,1,3,-1,A,"Evans, Roy",2,Away
3676,1996-02-24,1995.0,Blackburn Rovers,Liverpool,2-3,2,3,1,1,5,-1,A,"Evans, Roy",3,Away
3677,1996-03-03,1995.0,Liverpool,Aston Villa,3-0,3,0,1,1,3,3,H,"Evans, Roy",3,Anfield
3678,1996-03-13,1995.0,Liverpool,Wimbledon,2-2,2,2,1,1,4,0,D,"Evans, Roy",2,Anfield
3679,1996-03-16,1995.0,Liverpool,Chelsea,2-0,2,0,1,1,2,2,H,"Evans, Roy",2,Anfield
3680,1996-03-23,1995.0,Nottingham Forest,Liverpool,1-0,1,0,1,1,1,1,H,"Evans, Roy",0,Away
3681,1996-04-03,1995.0,Liverpool,Newcastle United,4-3,4,3,1,1,7,1,H,"Evans, Roy",4,Anfield
3682,1996-04-06,1995.0,Coventry City,Liverpool,1-0,1,0,1,1,1,1,H,"Evans, Roy",0,Away
3683,1996-04-08,1995.0,Liverpool,West Ham United,2-0,2,0,1,1,2,2,H,"Evans, Roy",2,Anfield
3684,1996-04-16,1995.0,Everton,Liverpool,1-1,1,1,1,1,2,0,D,"Evans, Roy",1,Away
3685,1996-04-27,1995.0,Liverpool,Middlesbrough,1-0,1,0,1,1,1,1,H,"Evans, Roy",1,Anfield
3686,1996-05-01,1995.0,Arsenal,Liverpool,0-0,0,0,1,1,0,0,D,"Evans, Roy",0,Away
3687,1996-05-04,1995.0,Manchester City,Liverpool,2-2,2,2,1,1,4,0,D,"Evans, Roy",2,Away
3688,1996-08-17,1996.0,Middlesbrough,Liverpool,3-3,3,3,1,1,6,0,D,"Evans, Roy",3,Away
3689,1996-08-19,1996.0,Liverpool,Arsenal,2-0,2,0,1,1,2,2,H,"Evans, Roy",2,Anfield
3690,1996-08-24,1996.0,Liverpool,Sunderland,0-0,0,0,1,1,0,0,D,"Evans, Roy",0,Anfield
3691,1996-09-04,1996.0,Coventry City,Liverpool,0-1,0,1,1,1,1,-1,A,"Evans, Roy",1,Away
3692,1996-09-07,1996.0,Liverpool,Southampton,2-1,2,1,1,1,3,1,H,"Evans, Roy",2,Anfield
3693,1996-09-15,1996.0,Leicester City,Liverpool,0-3,0,3,1,1,3,-3,A,"Evans, Roy",3,Away
3694,1996-09-21,1996.0,Liverpool,Chelsea,5-1,5,1,1,1,6,4,H,"Evans, Roy",5,Anfield
3695,1996-09-29,1996.0,West Ham United,Liverpool,1-2,1,2,1,1,3,-1,A,"Evans, Roy",2,Away
3696,1996-10-12,1996.0,Manchester United,Liverpool,1-0,1,0,1,1,1,1,H,"Evans, Roy",0,Away
3697,1996-10-27,1996.0,Liverpool,Derby County,2-1,2,1,1,1,3,1,H,"Evans, Roy",2,Anfield
3698,1996-11-03,1996.0,Blackburn Rovers,Liverpool,3-0,3,0,1,1,3,3,H,"Evans, Roy",0,Away
3699,1996-11-16,1996.0,Leeds United,Liverpool,0-2,0,2,1,1,2,-2,A,"Evans, Roy",2,Away
3700,1996-11-20,1996.0,Liverpool,Everton,1-1,1,1,1,1,2,0,D,"Evans, Roy",1,Anfield
3701,1996-11-23,1996.0,Liverpool,Wimbledon,1-1,1,1,1,1,2,0,D,"Evans, Roy",1,Anfield
3702,1996-12-02,1996.0,Tottenham Hotspur,Liverpool,0-2,0,2,1,1,2,-2,A,"Evans, Roy",2,Away
3703,1996-12-07,1996.0,Liverpool,Sheffield Wednesday,0-1,0,1,1,1,1,-1,A,"Evans, Roy",0,Anfield
3704,1996-12-14,1996.0,Liverpool,Middlesbrough,5-1,5,1,1,1,6,4,H,"Evans, Roy",5,Anfield
3705,1996-12-17,1996.0,Liverpool,Nottingham Forest,4-2,4,2,1,1,6,2,H,"Evans, Roy",4,Anfield
3706,1996-12-23,1996.0,Newcastle United,Liverpool,1-1,1,1,1,1,2,0,D,"Evans, Roy",1,Away
3707,1996-12-26,1996.0,Liverpool,Leicester City,1-1,1,1,1,1,2,0,D,"Evans, Roy",1,Anfield
3708,1996-12-29,1996.0,Southampton,Liverpool,0-1,0,1,1,1,1,-1,A,"Evans, Roy",1,Away
3709,1997-01-01,1996.0,Chelsea,Liverpool,1-0,1,0,1,1,1,1,H,"Evans, Roy",0,Away
3710,1997-01-11,1996.0,Liverpool,West Ham United,0-0,0,0,1,1,0,0,D,"Evans, Roy",0,Anfield
3711,1997-01-18,1996.0,Liverpool,Aston Villa,3-0,3,0,1,1,3,3,H,"Evans, Roy",3,Anfield
3712,1997-02-01,1996.0,Derby County,Liverpool,0-1,0,1,1,1,1,-1,A,"Evans, Roy",1,Away
3713,1997-02-19,1996.0,Liverpool,Leeds United,4-0,4,0,1,1,4,4,H,"Evans, Roy",4,Anfield
3714,1997-02-22,1996.0,Liverpool,Blackburn Rovers,0-0,0,0,1,1,0,0,D,"Evans, Roy",0,Anfield
3715,1997-03-02,1996.0,Aston Villa,Liverpool,1-0,1,0,1,1,1,1,H,"Evans, Roy",0,Away
3716,1997-03-10,1996.0,Liverpool,Newcastle United,4-3,4,3,1,1,7,1,H,"Evans, Roy",4,Anfield
3717,1997-03-15,1996.0,Nottingham Forest,Liverpool,1-1,1,1,1,1,2,0,D,"Evans, Roy",1,Away
3718,1997-03-24,1996.0,Arsenal,Liverpool,1-2,1,2,1,1,3,-1,A,"Evans, Roy",2,Away
3719,1997-04-06,1996.0,Liverpool,Coventry City,1-2,1,2,1,1,3,-1,A,"Evans, Roy",1,Anfield
3720,1997-04-13,1996.0,Sunderland,Liverpool,1-2,1,2,1,1,3,-1,A,"Evans, Roy",2,Away
3721,1997-04-16,1996.0,Everton,Liverpool,1-1,1,1,1,1,2,0,D,"Evans, Roy",1,Away
3722,1997-04-19,1996.0,Liverpool,Manchester United,1-3,1,3,1,1,4,-2,A,"Evans, Roy",1,Anfield
3723,1997-05-03,1996.0,Liverpool,Tottenham Hotspur,2-1,2,1,1,1,3,1,H,"Evans, Roy",2,Anfield
3724,1997-05-06,1996.0,Wimbledon,Liverpool,2-1,2,1,1,1,3,1,H,"Evans, Roy",1,Away
3725,1997-05-11,1996.0,Sheffield Wednesday,Liverpool,1-1,1,1,1,1,2,0,D,"Evans, Roy",1,Away
3726,1997-08-09,1997.0,Wimbledon,Liverpool,1-1,1,1,1,1,2,0,D,"Evans, Roy",1,Away
3727,1997-08-13,1997.0,Liverpool,Leicester City,1-2,1,2,1,1,3,-1,A,"Evans, Roy",1,Anfield
3728,1997-08-23,1997.0,Blackburn Rovers,Liverpool,1-1,1,1,1,1,2,0,D,"Evans, Roy",1,Away
3729,1997-08-26,1997.0,Leeds United,Liverpool,0-2,0,2,1,1,2,-2,A,"Evans, Roy",2,Away
3730,1997-09-13,1997.0,Liverpool,Sheffield Wednesday,2-1,2,1,1,1,3,1,H,"Evans, Roy",2,Anfield
3731,1997-09-20,1997.0,Southampton,Liverpool,1-1,1,1,1,1,2,0,D,"Evans, Roy",1,Away
3732,1997-09-22,1997.0,Liverpool,Aston Villa,3-0,3,0,1,1,3,3,H,"Evans, Roy",3,Anfield
3733,1997-09-27,1997.0,West Ham United,Liverpool,2-1,2,1,1,1,3,1,H,"Evans, Roy",1,Away
3734,1997-10-05,1997.0,Liverpool,Chelsea,4-2,4,2,1,1,6,2,H,"Evans, Roy",4,Anfield
3735,1997-10-18,1997.0,Everton,Liverpool,2-0,2,0,1,1,2,2,H,"Evans, Roy",0,Away
3736,1997-10-25,1997.0,Liverpool,Derby County,4-0,4,0,1,1,4,4,H,"Evans, Roy",4,Anfield
3737,1997-11-01,1997.0,Bolton Wanderers,Liverpool,1-1,1,1,1,1,2,0,D,"Evans, Roy",1,Away
3738,1997-11-08,1997.0,Liverpool,Tottenham Hotspur,4-0,4,0,1,1,4,4,H,"Evans, Roy",4,Anfield
3739,1997-11-22,1997.0,Liverpool,Barnsley,0-1,0,1,1,1,1,-1,A,"Evans, Roy",0,Anfield
3740,1997-11-30,1997.0,Arsenal,Liverpool,0-1,0,1,1,1,1,-1,A,"Evans, Roy",1,Away
3741,1997-12-06,1997.0,Liverpool,Manchester United,1-3,1,3,1,1,4,-2,A,"Evans, Roy",1,Anfield
3742,1997-12-13,1997.0,Crystal Palace,Liverpool,0-3,0,3,1,1,3,-3,A,"Evans, Roy",3,Away
3743,1997-12-20,1997.0,Liverpool,Coventry City,1-0,1,0,1,1,1,1,H,"Evans, Roy",1,Anfield
3744,1997-12-26,1997.0,Liverpool,Leeds United,3-1,3,1,1,1,4,2,H,"Evans, Roy",3,Anfield
3745,1997-12-28,1997.0,Newcastle United,Liverpool,1-2,1,2,1,1,3,-1,A,"Evans, Roy",2,Away
3746,1998-01-10,1997.0,Liverpool,Wimbledon,2-0,2,0,1,1,2,2,H,"Evans, Roy",2,Anfield
3747,1998-01-17,1997.0,Leicester City,Liverpool,0-0,0,0,1,1,0,0,D,"Evans, Roy",0,Away
3748,1998-01-20,1997.0,Liverpool,Newcastle United,1-0,1,0,1,1,1,1,H,"Evans, Roy",1,Anfield
3749,1998-01-31,1997.0,Liverpool,Blackburn Rovers,0-0,0,0,1,1,0,0,D,"Evans, Roy",0,Anfield
3750,1998-02-07,1997.0,Liverpool,Southampton,2-3,2,3,1,1,5,-1,A,"Evans, Roy",2,Anfield
3751,1998-02-14,1997.0,Sheffield Wednesday,Liverpool,3-3,3,3,1,1,6,0,D,"Evans, Roy",3,Away
3752,1998-02-23,1997.0,Liverpool,Everton,1-1,1,1,1,1,2,0,D,"Evans, Roy",1,Anfield
3753,1998-02-28,1997.0,Aston Villa,Liverpool,2-1,2,1,1,1,3,1,H,"Evans, Roy",1,Away
3754,1998-03-07,1997.0,Liverpool,Bolton Wanderers,2-1,2,1,1,1,3,1,H,"Evans, Roy",2,Anfield
3755,1998-03-14,1997.0,Tottenham Hotspur,Liverpool,3-3,3,3,1,1,6,0,D,"Evans, Roy",3,Away
3756,1998-03-28,1997.0,Barnsley,Liverpool,2-3,2,3,1,1,5,-1,A,"Evans, Roy",3,Away
3757,1998-04-10,1997.0,Manchester United,Liverpool,1-1,1,1,1,1,2,0,D,"Evans, Roy",1,Away
3758,1998-04-13,1997.0,Liverpool,Crystal Palace,2-1,2,1,1,1,3,1,H,"Evans, Roy",2,Anfield
3759,1998-04-19,1997.0,Coventry City,Liverpool,1-1,1,1,1,1,2,0,D,"Evans, Roy",1,Away
3760,1998-04-25,1997.0,Chelsea,Liverpool,4-1,4,1,1,1,5,3,H,"Evans, Roy",1,Away
3761,1998-05-02,1997.0,Liverpool,West Ham United,5-0,5,0,1,1,5,5,H,"Evans, Roy",5,Anfield
3762,1998-05-06,1997.0,Liverpool,Arsenal,4-0,4,0,1,1,4,4,H,"Evans, Roy",4,Anfield
3763,1998-05-10,1997.0,Derby County,Liverpool,1-0,1,0,1,1,1,1,H,"Evans, Roy",0,Away
3764,1998-08-16,1998.0,Southampton,Liverpool,1-2,1,2,1,1,3,-1,A,"Evans, Roy",2,Away
3765,1998-08-22,1998.0,Liverpool,Arsenal,0-0,0,0,1,1,0,0,D,"Evans, Roy",0,Anfield
3766,1998-08-30,1998.0,Newcastle United,Liverpool,1-4,1,4,1,1,5,-3,A,"Evans, Roy",4,Away
3767,1998-09-09,1998.0,Liverpool,Coventry City,2-0,2,0,1,1,2,2,H,"Evans, Roy",2,Anfield
3768,1998-09-12,1998.0,West Ham United,Liverpool,2-1,2,1,1,1,3,1,H,"Evans, Roy",1,Away
3769,1998-09-19,1998.0,Liverpool,Charlton Athletic,3-3,3,3,1,1,6,0,D,"Evans, Roy",3,Anfield
3770,1998-09-24,1998.0,Manchester United,Liverpool,2-0,2,0,1,1,2,2,H,"Evans, Roy",0,Away
3771,1998-10-04,1998.0,Liverpool,Chelsea,1-1,1,1,1,1,2,0,D,"Evans, Roy",1,Anfield
3772,1998-10-17,1998.0,Everton,Liverpool,0-0,0,0,1,1,0,0,D,"Evans, Roy",0,Away
3773,1998-10-24,1998.0,Liverpool,Nottingham Forest,5-1,5,1,1,1,6,4,H,"Evans, Roy",5,Anfield
3774,1998-10-31,1998.0,Leicester City,Liverpool,1-0,1,0,1,1,1,1,H,"Evans, Roy",0,Away
3775,1998-11-07,1998.0,Liverpool,Derby County,1-2,1,2,1,1,3,-1,A,"Evans, Roy",1,Anfield
3776,1998-11-14,1998.0,Liverpool,Leeds United,1-3,1,3,1,1,4,-2,A,"Houllier, Gérard",1,Anfield
3777,1998-11-21,1998.0,Aston Villa,Liverpool,2-4,2,4,1,1,6,-2,A,"Houllier, Gérard",4,Away
3778,1998-11-29,1998.0,Liverpool,Blackburn Rovers,2-0,2,0,1,1,2,2,H,"Houllier, Gérard",2,Anfield
3779,1998-12-05,1998.0,Tottenham Hotspur,Liverpool,2-1,2,1,1,1,3,1,H,"Houllier, Gérard",1,Away
3780,1998-12-13,1998.0,Wimbledon,Liverpool,1-0,1,0,1,1,1,1,H,"Houllier, Gérard",0,Away
3781,1998-12-19,1998.0,Liverpool,Sheffield Wednesday,2-0,2,0,1,1,2,2,H,"Houllier, Gérard",2,Anfield
3782,1998-12-26,1998.0,Middlesbrough,Liverpool,1-3,1,3,1,1,4,-2,A,"Houllier, Gérard",3,Away
3783,1998-12-28,1998.0,Liverpool,Newcastle United,4-2,4,2,1,1,6,2,H,"Houllier, Gérard",4,Anfield
3784,1999-01-09,1998.0,Arsenal,Liverpool,0-0,0,0,1,1,0,0,D,"Houllier, Gérard",0,Away
3785,1999-01-16,1998.0,Liverpool,Southampton,7-1,7,1,1,1,8,6,H,"Houllier, Gérard",7,Anfield
3786,1999-01-30,1998.0,Coventry City,Liverpool,2-1,2,1,1,1,3,1,H,"Houllier, Gérard",1,Away
3787,1999-02-06,1998.0,Liverpool,Middlesbrough,3-1,3,1,1,1,4,2,H,"Houllier, Gérard",3,Anfield
3788,1999-02-13,1998.0,Charlton Athletic,Liverpool,1-0,1,0,1,1,1,1,H,"Houllier, Gérard",0,Away
3789,1999-02-20,1998.0,Liverpool,West Ham United,2-2,2,2,1,1,4,0,D,"Houllier, Gérard",2,Anfield
3790,1999-02-27,1998.0,Chelsea,Liverpool,2-1,2,1,1,1,3,1,H,"Houllier, Gérard",1,Away
3791,1999-03-13,1998.0,Derby County,Liverpool,3-2,3,2,1,1,5,1,H,"Houllier, Gérard",2,Away
3792,1999-04-03,1998.0,Liverpool,Everton,3-2,3,2,1,1,5,1,H,"Houllier, Gérard",3,Anfield
3793,1999-04-05,1998.0,Nottingham Forest,Liverpool,2-2,2,2,1,1,4,0,D,"Houllier, Gérard",2,Away
3794,1999-04-12,1998.0,Leeds United,Liverpool,0-0,0,0,1,1,0,0,D,"Houllier, Gérard",0,Away
3795,1999-04-17,1998.0,Liverpool,Aston Villa,0-1,0,1,1,1,1,-1,A,"Houllier, Gérard",0,Anfield
3796,1999-04-21,1998.0,Liverpool,Leicester City,0-1,0,1,1,1,1,-1,A,"Houllier, Gérard",0,Anfield
3797,1999-04-24,1998.0,Blackburn Rovers,Liverpool,1-3,1,3,1,1,4,-2,A,"Houllier, Gérard",3,Away
3798,1999-05-01,1998.0,Liverpool,Tottenham Hotspur,3-2,3,2,1,1,5,1,H,"Houllier, Gérard",3,Anfield
3799,1999-05-05,1998.0,Liverpool,Manchester United,2-2,2,2,1,1,4,0,D,"Houllier, Gérard",2,Anfield
3800,1999-05-08,1998.0,Sheffield Wednesday,Liverpool,1-0,1,0,1,1,1,1,H,"Houllier, Gérard",0,Away
3801,1999-05-16,1998.0,Liverpool,Wimbledon,3-0,3,0,1,1,3,3,H,"Houllier, Gérard",3,Anfield
3802,1999-08-07,1999.0,Sheffield Wednesday,Liverpool,1-2,1,2,1,1,3,-1,A,"Houllier, Gérard",2,Away
3803,1999-08-14,1999.0,Liverpool,Watford,0-1,0,1,1,1,1,-1,A,"Houllier, Gérard",0,Anfield
3804,1999-08-21,1999.0,Middlesbrough,Liverpool,1-0,1,0,1,1,1,1,H,"Houllier, Gérard",0,Away
3805,1999-08-23,1999.0,Leeds United,Liverpool,1-2,1,2,1,1,3,-1,A,"Houllier, Gérard",2,Away
3806,1999-08-28,1999.0,Liverpool,Arsenal,2-0,2,0,1,1,2,2,H,"Houllier, Gérard",2,Anfield
3807,1999-09-11,1999.0,Liverpool,Manchester United,2-3,2,3,1,1,5,-1,A,"Houllier, Gérard",2,Anfield
3808,1999-09-18,1999.0,Leicester City,Liverpool,2-2,2,2,1,1,4,0,D,"Houllier, Gérard",2,Away
3809,1999-09-27,1999.0,Liverpool,Everton,0-1,0,1,1,1,1,-1,A,"Houllier, Gérard",0,Anfield
3810,1999-10-02,1999.0,Aston Villa,Liverpool,0-0,0,0,1,1,0,0,D,"Houllier, Gérard",0,Away
3811,1999-10-16,1999.0,Liverpool,Chelsea,1-0,1,0,1,1,1,1,H,"Houllier, Gérard",1,Anfield
3812,1999-10-23,1999.0,Southampton,Liverpool,1-1,1,1,1,1,2,0,D,"Houllier, Gérard",1,Away
3813,1999-10-27,1999.0,Liverpool,West Ham United,1-0,1,0,1,1,1,1,H,"Houllier, Gérard",1,Anfield
3814,1999-11-01,1999.0,Liverpool,Bradford City,3-1,3,1,1,1,4,2,H,"Houllier, Gérard",3,Anfield
3815,1999-11-06,1999.0,Liverpool,Derby County,2-0,2,0,1,1,2,2,H,"Houllier, Gérard",2,Anfield
3816,1999-11-20,1999.0,Sunderland,Liverpool,0-2,0,2,1,1,2,-2,A,"Houllier, Gérard",2,Away
3817,1999-11-27,1999.0,West Ham United,Liverpool,1-0,1,0,1,1,1,1,H,"Houllier, Gérard",0,Away
3818,1999-12-05,1999.0,Liverpool,Sheffield Wednesday,4-1,4,1,1,1,5,3,H,"Houllier, Gérard",4,Anfield
3819,1999-12-18,1999.0,Liverpool,Coventry City,2-0,2,0,1,1,2,2,H,"Houllier, Gérard",2,Anfield
3820,1999-12-26,1999.0,Newcastle United,Liverpool,2-2,2,2,1,1,4,0,D,"Houllier, Gérard",2,Away
3821,1999-12-28,1999.0,Liverpool,Wimbledon,3-1,3,1,1,1,4,2,H,"Houllier, Gérard",3,Anfield
3822,2000-01-03,1999.0,Tottenham Hotspur,Liverpool,1-0,1,0,1,1,1,1,H,"Houllier, Gérard",0,Away
3823,2000-01-15,1999.0,Watford,Liverpool,2-3,2,3,1,1,5,-1,A,"Houllier, Gérard",3,Away
3824,2000-01-22,1999.0,Liverpool,Middlesbrough,0-0,0,0,1,1,0,0,D,"Houllier, Gérard",0,Anfield
3825,2000-02-05,1999.0,Liverpool,Leeds United,3-1,3,1,1,1,4,2,H,"Houllier, Gérard",3,Anfield
3826,2000-02-13,1999.0,Arsenal,Liverpool,0-1,0,1,1,1,1,-1,A,"Houllier, Gérard",1,Away
3827,2000-03-04,1999.0,Manchester United,Liverpool,1-1,1,1,1,1,2,0,D,"Houllier, Gérard",1,Away
3828,2000-03-11,1999.0,Liverpool,Sunderland,1-1,1,1,1,1,2,0,D,"Houllier, Gérard",1,Anfield
3829,2000-03-15,1999.0,Liverpool,Aston Villa,0-0,0,0,1,1,0,0,D,"Houllier, Gérard",0,Anfield
3830,2000-03-18,1999.0,Derby County,Liverpool,0-2,0,2,1,1,2,-2,A,"Houllier, Gérard",2,Away
3831,2000-03-25,1999.0,Liverpool,Newcastle United,2-1,2,1,1,1,3,1,H,"Houllier, Gérard",2,Anfield
3832,2000-04-01,1999.0,Coventry City,Liverpool,0-3,0,3,1,1,3,-3,A,"Houllier, Gérard",3,Away
3833,2000-04-09,1999.0,Liverpool,Tottenham Hotspur,2-0,2,0,1,1,2,2,H,"Houllier, Gérard",2,Anfield
3834,2000-04-16,1999.0,Wimbledon,Liverpool,1-2,1,2,1,1,3,-1,A,"Houllier, Gérard",2,Away
3835,2000-04-21,1999.0,Everton,Liverpool,0-0,0,0,1,1,0,0,D,"Houllier, Gérard",0,Away
3836,2000-04-29,1999.0,Chelsea,Liverpool,2-0,2,0,1,1,2,2,H,"Houllier, Gérard",0,Away
3837,2000-05-03,1999.0,Liverpool,Leicester City,0-2,0,2,1,1,2,-2,A,"Houllier, Gérard",0,Anfield
3838,2000-05-07,1999.0,Liverpool,Southampton,0-0,0,0,1,1,0,0,D,"Houllier, Gérard",0,Anfield
3839,2000-05-14,1999.0,Bradford City,Liverpool,1-0,1,0,1,1,1,1,H,"Houllier, Gérard",0,Away
3840,2000-08-19,2000.0,Liverpool,Bradford City,1-0,1,0,1,1,1,1,H,"Houllier, Gérard",1,Anfield
3841,2000-08-21,2000.0,Arsenal,Liverpool,2-0,2,0,1,1,2,2,H,"Houllier, Gérard",0,Away
3842,2000-08-26,2000.0,Southampton,Liverpool,3-3,3,3,1,1,6,0,D,"Houllier, Gérard",3,Away
3843,2000-09-06,2000.0,Liverpool,Aston Villa,3-1,3,1,1,1,4,2,H,"Houllier, Gérard",3,Anfield
3844,2000-09-09,2000.0,Liverpool,Manchester City,3-2,3,2,1,1,5,1,H,"Houllier, Gérard",3,Anfield
3845,2000-09-17,2000.0,West Ham United,Liverpool,1-1,1,1,1,1,2,0,D,"Houllier, Gérard",1,Away
3846,2000-09-23,2000.0,Liverpool,Sunderland,1-1,1,1,1,1,2,0,D,"Houllier, Gérard",1,Anfield
3847,2000-10-01,2000.0,Chelsea,Liverpool,3-0,3,0,1,1,3,3,H,"Houllier, Gérard",0,Away
3848,2000-10-15,2000.0,Derby County,Liverpool,0-4,0,4,1,1,4,-4,A,"Houllier, Gérard",4,Away
3849,2000-10-21,2000.0,Liverpool,Leicester City,1-0,1,0,1,1,1,1,H,"Houllier, Gérard",1,Anfield
3850,2000-10-29,2000.0,Liverpool,Everton,3-1,3,1,1,1,4,2,H,"Houllier, Gérard",3,Anfield
3851,2000-11-04,2000.0,Leeds United,Liverpool,4-3,4,3,1,1,7,1,H,"Houllier, Gérard",3,Away
3852,2000-11-12,2000.0,Liverpool,Coventry City,4-1,4,1,1,1,5,3,H,"Houllier, Gérard",4,Anfield
3853,2000-11-19,2000.0,Tottenham Hotspur,Liverpool,2-1,2,1,1,1,3,1,H,"Houllier, Gérard",1,Away
3854,2000-11-26,2000.0,Newcastle United,Liverpool,2-1,2,1,1,1,3,1,H,"Houllier, Gérard",1,Away
3855,2000-12-02,2000.0,Liverpool,Charlton Athletic,3-0,3,0,1,1,3,3,H,"Houllier, Gérard",3,Anfield
3856,2000-12-10,2000.0,Liverpool,Ipswich Town,0-1,0,1,1,1,1,-1,A,"Houllier, Gérard",0,Anfield
3857,2000-12-17,2000.0,Manchester United,Liverpool,0-1,0,1,1,1,1,-1,A,"Houllier, Gérard",1,Away
3858,2000-12-23,2000.0,Liverpool,Arsenal,4-0,4,0,1,1,4,4,H,"Houllier, Gérard",4,Anfield
3859,2000-12-26,2000.0,Middlesbrough,Liverpool,1-0,1,0,1,1,1,1,H,"Houllier, Gérard",0,Away
3860,2001-01-01,2000.0,Liverpool,Southampton,2-1,2,1,1,1,3,1,H,"Houllier, Gérard",2,Anfield
3861,2001-01-13,2000.0,Aston Villa,Liverpool,0-3,0,3,1,1,3,-3,A,"Houllier, Gérard",3,Away
3862,2001-01-20,2000.0,Liverpool,Middlesbrough,0-0,0,0,1,1,0,0,D,"Houllier, Gérard",0,Anfield
3863,2001-01-31,2000.0,Manchester City,Liverpool,1-1,1,1,1,1,2,0,D,"Houllier, Gérard",1,Away
3864,2001-02-03,2000.0,Liverpool,West Ham United,3-0,3,0,1,1,3,3,H,"Houllier, Gérard",3,Anfield
3865,2001-02-10,2000.0,Sunderland,Liverpool,1-1,1,1,1,1,2,0,D,"Houllier, Gérard",1,Away
3866,2001-03-03,2000.0,Leicester City,Liverpool,2-0,2,0,1,1,2,2,H,"Houllier, Gérard",0,Away
3867,2001-03-18,2000.0,Liverpool,Derby County,1-1,1,1,1,1,2,0,D,"Houllier, Gérard",1,Anfield
3868,2001-03-31,2000.0,Liverpool,Manchester United,2-0,2,0,1,1,2,2,H,"Houllier, Gérard",2,Anfield
3869,2001-04-10,2000.0,Ipswich Town,Liverpool,1-1,1,1,1,1,2,0,D,"Houllier, Gérard",1,Away
3870,2001-04-13,2000.0,Liverpool,Leeds United,1-2,1,2,1,1,3,-1,A,"Houllier, Gérard",1,Anfield
3871,2001-04-16,2000.0,Everton,Liverpool,2-3,2,3,1,1,5,-1,A,"Houllier, Gérard",3,Away
3872,2001-04-22,2000.0,Liverpool,Tottenham Hotspur,3-1,3,1,1,1,4,2,H,"Houllier, Gérard",3,Anfield
3873,2001-04-28,2000.0,Coventry City,Liverpool,0-2,0,2,1,1,2,-2,A,"Houllier, Gérard",2,Away
3874,2001-05-01,2000.0,Bradford City,Liverpool,0-2,0,2,1,1,2,-2,A,"Houllier, Gérard",2,Away
3875,2001-05-05,2000.0,Liverpool,Newcastle United,3-0,3,0,1,1,3,3,H,"Houllier, Gérard",3,Anfield
3876,2001-05-08,2000.0,Liverpool,Chelsea,2-2,2,2,1,1,4,0,D,"Houllier, Gérard",2,Anfield
3877,2001-05-19,2000.0,Charlton Athletic,Liverpool,0-4,0,4,1,1,4,-4,A,"Houllier, Gérard",4,Away
3878,2001-08-18,2001.0,Liverpool,West Ham United,2-1,2,1,1,1,3,1,H,"Houllier, Gérard",2,Anfield
3879,2001-08-27,2001.0,Bolton Wanderers,Liverpool,2-1,2,1,1,1,3,1,H,"Houllier, Gérard",1,Away
3880,2001-09-08,2001.0,Liverpool,Aston Villa,1-3,1,3,1,1,4,-2,A,"Houllier, Gérard",1,Anfield
3881,2001-09-15,2001.0,Everton,Liverpool,1-3,1,3,1,1,4,-2,A,"Houllier, Gérard",3,Away
3882,2001-09-22,2001.0,Liverpool,Tottenham Hotspur,1-0,1,0,1,1,1,1,H,"Houllier, Gérard",1,Anfield
3883,2001-09-30,2001.0,Newcastle United,Liverpool,0-2,0,2,1,1,2,-2,A,"Houllier, Gérard",2,Away
3884,2001-10-13,2001.0,Liverpool,Leeds United,1-1,1,1,1,1,2,0,D,"Houllier, Gérard",1,Anfield
3885,2001-10-20,2001.0,Leicester City,Liverpool,1-4,1,4,1,1,5,-3,A,"Houllier, Gérard",4,Away
3886,2001-10-27,2001.0,Charlton Athletic,Liverpool,0-2,0,2,1,1,2,-2,A,"Houllier, Gérard",2,Away
3887,2001-11-04,2001.0,Liverpool,Manchester United,3-1,3,1,1,1,4,2,H,"Houllier, Gérard",3,Anfield
3888,2001-11-17,2001.0,Blackburn Rovers,Liverpool,1-1,1,1,1,1,2,0,D,"Houllier, Gérard",1,Away
3889,2001-11-25,2001.0,Liverpool,Sunderland,1-0,1,0,1,1,1,1,H,"Houllier, Gérard",1,Anfield
3890,2001-12-01,2001.0,Derby County,Liverpool,0-1,0,1,1,1,1,-1,A,"Houllier, Gérard",1,Away
3891,2001-12-08,2001.0,Liverpool,Middlesbrough,2-0,2,0,1,1,2,2,H,"Houllier, Gérard",2,Anfield
3892,2001-12-12,2001.0,Liverpool,Fulham,0-0,0,0,1,1,0,0,D,"Houllier, Gérard",0,Anfield
3893,2001-12-16,2001.0,Chelsea,Liverpool,4-0,4,0,1,1,4,4,H,"Houllier, Gérard",0,Away
3894,2001-12-23,2001.0,Liverpool,Arsenal,1-2,1,2,1,1,3,-1,A,"Houllier, Gérard",1,Anfield
3895,2001-12-26,2001.0,Aston Villa,Liverpool,1-2,1,2,1,1,3,-1,A,"Houllier, Gérard",2,Away
3896,2001-12-29,2001.0,West Ham United,Liverpool,1-1,1,1,1,1,2,0,D,"Houllier, Gérard",1,Away
3897,2002-01-01,2001.0,Liverpool,Bolton Wanderers,1-1,1,1,1,1,2,0,D,"Houllier, Gérard",1,Anfield
3898,2002-01-09,2001.0,Southampton,Liverpool,2-0,2,0,1,1,2,2,H,"Houllier, Gérard",0,Away
3899,2002-01-13,2001.0,Arsenal,Liverpool,1-1,1,1,1,1,2,0,D,"Houllier, Gérard",1,Away
3900,2002-01-19,2001.0,Liverpool,Southampton,1-1,1,1,1,1,2,0,D,"Houllier, Gérard",1,Anfield
3901,2002-01-22,2001.0,Manchester United,Liverpool,0-1,0,1,1,1,1,-1,A,"Houllier, Gérard",1,Away
3902,2002-01-30,2001.0,Liverpool,Leicester City,1-0,1,0,1,1,1,1,H,"Houllier, Gérard",1,Anfield
3903,2002-02-03,2001.0,Leeds United,Liverpool,0-4,0,4,1,1,4,-4,A,"Houllier, Gérard",4,Away
3904,2002-02-09,2001.0,Ipswich Town,Liverpool,0-6,0,6,1,1,6,-6,A,"Houllier, Gérard",6,Away
3905,2002-02-23,2001.0,Liverpool,Everton,1-1,1,1,1,1,2,0,D,"Houllier, Gérard",1,Anfield
3906,2002-03-02,2001.0,Fulham,Liverpool,0-2,0,2,1,1,2,-2,A,"Houllier, Gérard",2,Away
3907,2002-03-06,2001.0,Liverpool,Newcastle United,3-0,3,0,1,1,3,3,H,"Houllier, Gérard",3,Anfield
3908,2002-03-16,2001.0,Middlesbrough,Liverpool,1-2,1,2,1,1,3,-1,A,"Houllier, Gérard",2,Away
3909,2002-03-24,2001.0,Liverpool,Chelsea,1-0,1,0,1,1,1,1,H,"Houllier, Gérard",1,Anfield
3910,2002-03-30,2001.0,Liverpool,Charlton Athletic,2-0,2,0,1,1,2,2,H,"Houllier, Gérard",2,Anfield
3911,2002-04-13,2001.0,Sunderland,Liverpool,0-1,0,1,1,1,1,-1,A,"Houllier, Gérard",1,Away
3912,2002-04-20,2001.0,Liverpool,Derby County,2-0,2,0,1,1,2,2,H,"Houllier, Gérard",2,Anfield
3913,2002-04-27,2001.0,Tottenham Hotspur,Liverpool,1-0,1,0,1,1,1,1,H,"Houllier, Gérard",0,Away
3914,2002-05-08,2001.0,Liverpool,Blackburn Rovers,4-3,4,3,1,1,7,1,H,"Houllier, Gérard",4,Anfield
3915,2002-05-11,2001.0,Liverpool,Ipswich Town,5-0,5,0,1,1,5,5,H,"Houllier, Gérard",5,Anfield
3916,2002-08-18,2002.0,Aston Villa,Liverpool,0-1,0,1,1,1,1,-1,A,"Houllier, Gérard",1,Away
3917,2002-08-24,2002.0,Liverpool,Southampton,3-0,3,0,1,1,3,3,H,"Houllier, Gérard",3,Anfield
3918,2002-08-28,2002.0,Blackburn Rovers,Liverpool,2-2,2,2,1,1,4,0,D,"Houllier, Gérard",2,Away
3919,2002-09-02,2002.0,Liverpool,Newcastle United,2-2,2,2,1,1,4,0,D,"Houllier, Gérard",2,Anfield
3920,2002-09-11,2002.0,Liverpool,Birmingham City,2-2,2,2,1,1,4,0,D,"Houllier, Gérard",2,Anfield
3921,2002-09-14,2002.0,Bolton Wanderers,Liverpool,2-3,2,3,1,1,5,-1,A,"Houllier, Gérard",3,Away
3922,2002-09-21,2002.0,Liverpool,West Bromwich Albion,2-0,2,0,1,1,2,2,H,"Houllier, Gérard",2,Anfield
3923,2002-09-28,2002.0,Manchester City,Liverpool,0-3,0,3,1,1,3,-3,A,"Houllier, Gérard",3,Away
3924,2002-10-06,2002.0,Liverpool,Chelsea,1-0,1,0,1,1,1,1,H,"Houllier, Gérard",1,Anfield
3925,2002-10-19,2002.0,Leeds United,Liverpool,0-1,0,1,1,1,1,-1,A,"Houllier, Gérard",1,Away
3926,2002-10-26,2002.0,Liverpool,Tottenham Hotspur,2-1,2,1,1,1,3,1,H,"Houllier, Gérard",2,Anfield
3927,2002-11-02,2002.0,Liverpool,West Ham United,2-0,2,0,1,1,2,2,H,"Houllier, Gérard",2,Anfield
3928,2002-11-09,2002.0,Middlesbrough,Liverpool,1-0,1,0,1,1,1,1,H,"Houllier, Gérard",0,Away
3929,2002-11-17,2002.0,Liverpool,Sunderland,0-0,0,0,1,1,0,0,D,"Houllier, Gérard",0,Anfield
3930,2002-11-23,2002.0,Fulham,Liverpool,3-2,3,2,1,1,5,1,H,"Houllier, Gérard",2,Away
3931,2002-12-01,2002.0,Liverpool,Manchester United,1-2,1,2,1,1,3,-1,A,"Houllier, Gérard",1,Anfield
3932,2002-12-07,2002.0,Charlton Athletic,Liverpool,2-0,2,0,1,1,2,2,H,"Houllier, Gérard",0,Away
3933,2002-12-15,2002.0,Sunderland,Liverpool,2-1,2,1,1,1,3,1,H,"Houllier, Gérard",1,Away
3934,2002-12-22,2002.0,Liverpool,Everton,0-0,0,0,1,1,0,0,D,"Houllier, Gérard",0,Anfield
3935,2002-12-26,2002.0,Liverpool,Blackburn Rovers,1-1,1,1,1,1,2,0,D,"Houllier, Gérard",1,Anfield
3936,2002-12-29,2002.0,Arsenal,Liverpool,1-1,1,1,1,1,2,0,D,"Houllier, Gérard",1,Away
3937,2003-01-01,2002.0,Newcastle United,Liverpool,1-0,1,0,1,1,1,1,H,"Houllier, Gérard",0,Away
3938,2003-01-11,2002.0,Liverpool,Aston Villa,1-1,1,1,1,1,2,0,D,"Houllier, Gérard",1,Anfield
3939,2003-01-18,2002.0,Southampton,Liverpool,0-1,0,1,1,1,1,-1,A,"Houllier, Gérard",1,Away
3940,2003-01-29,2002.0,Liverpool,Arsenal,2-2,2,2,1,1,4,0,D,"Houllier, Gérard",2,Anfield
3941,2003-02-02,2002.0,West Ham United,Liverpool,0-3,0,3,1,1,3,-3,A,"Houllier, Gérard",3,Away
3942,2003-02-08,2002.0,Liverpool,Middlesbrough,1-1,1,1,1,1,2,0,D,"Houllier, Gérard",1,Anfield
3943,2003-02-23,2002.0,Birmingham City,Liverpool,2-1,2,1,1,1,3,1,H,"Houllier, Gérard",1,Away
3944,2003-03-08,2002.0,Liverpool,Bolton Wanderers,2-0,2,0,1,1,2,2,H,"Houllier, Gérard",2,Anfield
3945,2003-03-16,2002.0,Tottenham Hotspur,Liverpool,2-3,2,3,1,1,5,-1,A,"Houllier, Gérard",3,Away
3946,2003-03-23,2002.0,Liverpool,Leeds United,3-1,3,1,1,1,4,2,H,"Houllier, Gérard",3,Anfield
3947,2003-04-05,2002.0,Manchester United,Liverpool,4-0,4,0,1,1,4,4,H,"Houllier, Gérard",0,Away
3948,2003-04-12,2002.0,Liverpool,Fulham,2-0,2,0,1,1,2,2,H,"Houllier, Gérard",2,Anfield
3949,2003-04-19,2002.0,Everton,Liverpool,1-2,1,2,1,1,3,-1,A,"Houllier, Gérard",2,Away
3950,2003-04-21,2002.0,Liverpool,Charlton Athletic,2-1,2,1,1,1,3,1,H,"Houllier, Gérard",2,Anfield
3951,2003-04-26,2002.0,West Bromwich Albion,Liverpool,0-6,0,6,1,1,6,-6,A,"Houllier, Gérard",6,Away
3952,2003-05-03,2002.0,Liverpool,Manchester City,1-2,1,2,1,1,3,-1,A,"Houllier, Gérard",1,Anfield
3953,2003-05-11,2002.0,Chelsea,Liverpool,2-1,2,1,1,1,3,1,H,"Houllier, Gérard",1,Away
3954,2003-08-17,2003.0,Liverpool,Chelsea,1-2,1,2,1,1,3,-1,A,"Houllier, Gérard",1,Anfield
3955,2003-08-24,2003.0,Aston Villa,Liverpool,0-0,0,0,1,1,0,0,D,"Houllier, Gérard",0,Away
3956,2003-08-27,2003.0,Liverpool,Tottenham Hotspur,0-0,0,0,1,1,0,0,D,"Houllier, Gérard",0,Anfield
3957,2003-08-30,2003.0,Everton,Liverpool,0-3,0,3,1,1,3,-3,A,"Houllier, Gérard",3,Away
3958,2003-09-13,2003.0,Blackburn Rovers,Liverpool,1-3,1,3,1,1,4,-2,A,"Houllier, Gérard",3,Away
3959,2003-09-20,2003.0,Liverpool,Leicester City,2-1,2,1,1,1,3,1,H,"Houllier, Gérard",2,Anfield
3960,2003-09-28,2003.0,Charlton Athletic,Liverpool,3-2,3,2,1,1,5,1,H,"Houllier, Gérard",2,Away
3961,2003-10-04,2003.0,Liverpool,Arsenal,1-2,1,2,1,1,3,-1,A,"Houllier, Gérard",1,Anfield
3962,2003-10-18,2003.0,Portsmouth,Liverpool,1-0,1,0,1,1,1,1,H,"Houllier, Gérard",0,Away
3963,2003-10-25,2003.0,Liverpool,Leeds United,3-1,3,1,1,1,4,2,H,"Houllier, Gérard",3,Anfield
3964,2003-11-02,2003.0,Fulham,Liverpool,1-2,1,2,1,1,3,-1,A,"Houllier, Gérard",2,Away
3965,2003-11-09,2003.0,Liverpool,Manchester United,1-2,1,2,1,1,3,-1,A,"Houllier, Gérard",1,Anfield
3966,2003-11-22,2003.0,Middlesbrough,Liverpool,0-0,0,0,1,1,0,0,D,"Houllier, Gérard",0,Away
3967,2003-11-30,2003.0,Liverpool,Birmingham City,3-1,3,1,1,1,4,2,H,"Houllier, Gérard",3,Anfield
3968,2003-12-06,2003.0,Newcastle United,Liverpool,1-1,1,1,1,1,2,0,D,"Houllier, Gérard",1,Away
3969,2003-12-13,2003.0,Liverpool,Southampton,1-2,1,2,1,1,3,-1,A,"Houllier, Gérard",1,Anfield
3970,2003-12-26,2003.0,Liverpool,Bolton Wanderers,3-1,3,1,1,1,4,2,H,"Houllier, Gérard",3,Anfield
3971,2003-12-28,2003.0,Manchester City,Liverpool,2-2,2,2,1,1,4,0,D,"Houllier, Gérard",2,Away
3972,2004-01-07,2003.0,Chelsea,Liverpool,0-1,0,1,1,1,1,-1,A,"Houllier, Gérard",1,Away
3973,2004-01-10,2003.0,Liverpool,Aston Villa,1-0,1,0,1,1,1,1,H,"Houllier, Gérard",1,Anfield
3974,2004-01-17,2003.0,Tottenham Hotspur,Liverpool,2-1,2,1,1,1,3,1,H,"Houllier, Gérard",1,Away
3975,2004-01-21,2003.0,Wolverhampton Wanderers,Liverpool,1-1,1,1,1,1,2,0,D,"Houllier, Gérard",1,Away
3976,2004-01-31,2003.0,Liverpool,Everton,0-0,0,0,1,1,0,0,D,"Houllier, Gérard",0,Anfield
3977,2004-02-07,2003.0,Bolton Wanderers,Liverpool,2-2,2,2,1,1,4,0,D,"Houllier, Gérard",2,Away
3978,2004-02-11,2003.0,Liverpool,Manchester City,2-1,2,1,1,1,3,1,H,"Houllier, Gérard",2,Anfield
3979,2004-02-29,2003.0,Leeds United,Liverpool,2-2,2,2,1,1,4,0,D,"Houllier, Gérard",2,Away
3980,2004-03-14,2003.0,Southampton,Liverpool,2-0,2,0,1,1,2,2,H,"Houllier, Gérard",0,Away
3981,2004-03-17,2003.0,Liverpool,Portsmouth,3-0,3,0,1,1,3,3,H,"Houllier, Gérard",3,Anfield
3982,2004-03-20,2003.0,Liverpool,Wolverhampton Wanderers,1-0,1,0,1,1,1,1,H,"Houllier, Gérard",1,Anfield
3983,2004-03-28,2003.0,Leicester City,Liverpool,0-0,0,0,1,1,0,0,D,"Houllier, Gérard",0,Away
3984,2004-04-04,2003.0,Liverpool,Blackburn Rovers,4-0,4,0,1,1,4,4,H,"Houllier, Gérard",4,Anfield
3985,2004-04-09,2003.0,Arsenal,Liverpool,4-2,4,2,1,1,6,2,H,"Houllier, Gérard",2,Away
3986,2004-04-12,2003.0,Liverpool,Charlton Athletic,0-1,0,1,1,1,1,-1,A,"Houllier, Gérard",0,Anfield
3987,2004-04-17,2003.0,Liverpool,Fulham,0-0,0,0,1,1,0,0,D,"Houllier, Gérard",0,Anfield
3988,2004-04-24,2003.0,Manchester United,Liverpool,0-1,0,1,1,1,1,-1,A,"Houllier, Gérard",1,Away
3989,2004-05-02,2003.0,Liverpool,Middlesbrough,2-0,2,0,1,1,2,2,H,"Houllier, Gérard",2,Anfield
3990,2004-05-08,2003.0,Birmingham City,Liverpool,0-3,0,3,1,1,3,-3,A,"Houllier, Gérard",3,Away
3991,2004-05-15,2003.0,Liverpool,Newcastle United,1-1,1,1,1,1,2,0,D,"Houllier, Gérard",1,Anfield
3992,2004-08-14,2004.0,Tottenham Hotspur,Liverpool,1-1,1,1,1,1,2,0,D,"Benítez, Rafael",1,Away
3993,2004-08-21,2004.0,Liverpool,Manchester City,2-1,2,1,1,1,3,1,H,"Benítez, Rafael",2,Anfield
3994,2004-08-29,2004.0,Bolton Wanderers,Liverpool,1-0,1,0,1,1,1,1,H,"Benítez, Rafael",0,Away
3995,2004-09-11,2004.0,Liverpool,West Bromwich Albion,3-0,3,0,1,1,3,3,H,"Benítez, Rafael",3,Anfield
3996,2004-09-20,2004.0,Manchester United,Liverpool,2-1,2,1,1,1,3,1,H,"Benítez, Rafael",1,Away
3997,2004-09-25,2004.0,Liverpool,Norwich City,3-0,3,0,1,1,3,3,H,"Benítez, Rafael",3,Anfield
3998,2004-10-03,2004.0,Chelsea,Liverpool,1-0,1,0,1,1,1,1,H,"Benítez, Rafael",0,Away
3999,2004-10-16,2004.0,Fulham,Liverpool,2-4,2,4,1,1,6,-2,A,"Benítez, Rafael",4,Away
4000,2004-10-23,2004.0,Liverpool,Charlton Athletic,2-0,2,0,1,1,2,2,H,"Benítez, Rafael",2,Anfield
4001,2004-10-30,2004.0,Blackburn Rovers,Liverpool,2-2,2,2,1,1,4,0,D,"Benítez, Rafael",2,Away
4002,2004-11-06,2004.0,Liverpool,Birmingham City,0-1,0,1,1,1,1,-1,A,"Benítez, Rafael",0,Anfield
4003,2004-11-13,2004.0,Liverpool,Crystal Palace,3-2,3,2,1,1,5,1,H,"Benítez, Rafael",3,Anfield
4004,2004-11-20,2004.0,Middlesbrough,Liverpool,2-0,2,0,1,1,2,2,H,"Benítez, Rafael",0,Away
4005,2004-11-28,2004.0,Liverpool,Arsenal,2-1,2,1,1,1,3,1,H,"Benítez, Rafael",2,Anfield
4006,2004-12-04,2004.0,Aston Villa,Liverpool,1-1,1,1,1,1,2,0,D,"Benítez, Rafael",1,Away
4007,2004-12-11,2004.0,Everton,Liverpool,1-0,1,0,1,1,1,1,H,"Benítez, Rafael",0,Away
4008,2004-12-14,2004.0,Liverpool,Portsmouth,1-1,1,1,1,1,2,0,D,"Benítez, Rafael",1,Anfield
4009,2004-12-19,2004.0,Liverpool,Newcastle United,3-1,3,1,1,1,4,2,H,"Benítez, Rafael",3,Anfield
4010,2004-12-26,2004.0,West Bromwich Albion,Liverpool,0-5,0,5,1,1,5,-5,A,"Benítez, Rafael",5,Away
4011,2004-12-28,2004.0,Liverpool,Southampton,1-0,1,0,1,1,1,1,H,"Benítez, Rafael",1,Anfield
4012,2005-01-01,2004.0,Liverpool,Chelsea,0-1,0,1,1,1,1,-1,A,"Benítez, Rafael",0,Anfield
4013,2005-01-03,2004.0,Norwich City,Liverpool,1-2,1,2,1,1,3,-1,A,"Benítez, Rafael",2,Away
4014,2005-01-15,2004.0,Liverpool,Manchester United,0-1,0,1,1,1,1,-1,A,"Benítez, Rafael",0,Anfield
4015,2005-01-22,2004.0,Southampton,Liverpool,2-0,2,0,1,1,2,2,H,"Benítez, Rafael",0,Away
4016,2005-02-01,2004.0,Charlton Athletic,Liverpool,1-2,1,2,1,1,3,-1,A,"Benítez, Rafael",2,Away
4017,2005-02-05,2004.0,Liverpool,Fulham,3-1,3,1,1,1,4,2,H,"Benítez, Rafael",3,Anfield
4018,2005-02-12,2004.0,Birmingham City,Liverpool,2-0,2,0,1,1,2,2,H,"Benítez, Rafael",0,Away
4019,2005-03-05,2004.0,Newcastle United,Liverpool,1-0,1,0,1,1,1,1,H,"Benítez, Rafael",0,Away
4020,2005-03-16,2004.0,Liverpool,Blackburn Rovers,0-0,0,0,1,1,0,0,D,"Benítez, Rafael",0,Anfield
4021,2005-03-20,2004.0,Liverpool,Everton,2-1,2,1,1,1,3,1,H,"Benítez, Rafael",2,Anfield
4022,2005-04-02,2004.0,Liverpool,Bolton Wanderers,1-0,1,0,1,1,1,1,H,"Benítez, Rafael",1,Anfield
4023,2005-04-09,2004.0,Manchester City,Liverpool,1-0,1,0,1,1,1,1,H,"Benítez, Rafael",0,Away
4024,2005-04-16,2004.0,Liverpool,Tottenham Hotspur,2-2,2,2,1,1,4,0,D,"Benítez, Rafael",2,Anfield
4025,2005-04-20,2004.0,Portsmouth,Liverpool,1-2,1,2,1,1,3,-1,A,"Benítez, Rafael",2,Away
4026,2005-04-23,2004.0,Crystal Palace,Liverpool,1-0,1,0,1,1,1,1,H,"Benítez, Rafael",0,Away
4027,2005-04-30,2004.0,Liverpool,Middlesbrough,1-1,1,1,1,1,2,0,D,"Benítez, Rafael",1,Anfield
4028,2005-05-08,2004.0,Arsenal,Liverpool,3-1,3,1,1,1,4,2,H,"Benítez, Rafael",1,Away
4029,2005-05-15,2004.0,Liverpool,Aston Villa,2-1,2,1,1,1,3,1,H,"Benítez, Rafael",2,Anfield
4030,2005-08-13,2005.0,Middlesbrough,Liverpool,0-0,0,0,1,1,0,0,D,"Benítez, Rafael",0,Away
4031,2005-08-20,2005.0,Liverpool,Sunderland,1-0,1,0,1,1,1,1,H,"Benítez, Rafael",1,Anfield
4032,2005-09-10,2005.0,Tottenham Hotspur,Liverpool,0-0,0,0,1,1,0,0,D,"Benítez, Rafael",0,Away
4033,2005-09-18,2005.0,Liverpool,Manchester United,0-0,0,0,1,1,0,0,D,"Benítez, Rafael",0,Anfield
4034,2005-09-24,2005.0,Birmingham City,Liverpool,2-2,2,2,1,1,4,0,D,"Benítez, Rafael",2,Away
4035,2005-10-02,2005.0,Liverpool,Chelsea,1-4,1,4,1,1,5,-3,A,"Benítez, Rafael",1,Anfield
4036,2005-10-15,2005.0,Liverpool,Blackburn Rovers,1-0,1,0,1,1,1,1,H,"Benítez, Rafael",1,Anfield
4037,2005-10-22,2005.0,Fulham,Liverpool,2-0,2,0,1,1,2,2,H,"Benítez, Rafael",0,Away
4038,2005-10-29,2005.0,Liverpool,West Ham United,2-0,2,0,1,1,2,2,H,"Benítez, Rafael",2,Anfield
4039,2005-11-05,2005.0,Aston Villa,Liverpool,0-2,0,2,1,1,2,-2,A,"Benítez, Rafael",2,Away
4040,2005-11-19,2005.0,Liverpool,Portsmouth,3-0,3,0,1,1,3,3,H,"Benítez, Rafael",3,Anfield
4041,2005-11-26,2005.0,Manchester City,Liverpool,0-1,0,1,1,1,1,-1,A,"Benítez, Rafael",1,Away
4042,2005-11-30,2005.0,Sunderland,Liverpool,0-2,0,2,1,1,2,-2,A,"Benítez, Rafael",2,Away
4043,2005-12-03,2005.0,Liverpool,Wigan Athletic,3-0,3,0,1,1,3,3,H,"Benítez, Rafael",3,Anfield
4044,2005-12-10,2005.0,Liverpool,Middlesbrough,2-0,2,0,1,1,2,2,H,"Benítez, Rafael",2,Anfield
4045,2005-12-26,2005.0,Liverpool,Newcastle United,2-0,2,0,1,1,2,2,H,"Benítez, Rafael",2,Anfield
4046,2005-12-28,2005.0,Everton,Liverpool,1-3,1,3,1,1,4,-2,A,"Benítez, Rafael",3,Away
4047,2005-12-31,2005.0,Liverpool,West Bromwich Albion,1-0,1,0,1,1,1,1,H,"Benítez, Rafael",1,Anfield
4048,2006-01-02,2005.0,Bolton Wanderers,Liverpool,2-2,2,2,1,1,4,0,D,"Benítez, Rafael",2,Away
4049,2006-01-14,2005.0,Liverpool,Tottenham Hotspur,1-0,1,0,1,1,1,1,H,"Benítez, Rafael",1,Anfield
4050,2006-01-22,2005.0,Manchester United,Liverpool,1-0,1,0,1,1,1,1,H,"Benítez, Rafael",0,Away
4051,2006-02-01,2005.0,Liverpool,Birmingham City,1-1,1,1,1,1,2,0,D,"Benítez, Rafael",1,Anfield
4052,2006-02-05,2005.0,Chelsea,Liverpool,2-0,2,0,1,1,2,2,H,"Benítez, Rafael",0,Away
4053,2006-02-08,2005.0,Charlton Athletic,Liverpool,2-0,2,0,1,1,2,2,H,"Benítez, Rafael",0,Away
4054,2006-02-11,2005.0,Wigan Athletic,Liverpool,0-1,0,1,1,1,1,-1,A,"Benítez, Rafael",1,Away
4055,2006-02-14,2005.0,Liverpool,Arsenal,1-0,1,0,1,1,1,1,H,"Benítez, Rafael",1,Anfield
4056,2006-02-26,2005.0,Liverpool,Manchester City,1-0,1,0,1,1,1,1,H,"Benítez, Rafael",1,Anfield
4057,2006-03-04,2005.0,Liverpool,Charlton Athletic,0-0,0,0,1,1,0,0,D,"Benítez, Rafael",0,Anfield
4058,2006-03-12,2005.0,Arsenal,Liverpool,2-1,2,1,1,1,3,1,H,"Benítez, Rafael",1,Away
4059,2006-03-15,2005.0,Liverpool,Fulham,5-1,5,1,1,1,6,4,H,"Benítez, Rafael",5,Anfield
4060,2006-03-19,2005.0,Newcastle United,Liverpool,1-3,1,3,1,1,4,-2,A,"Benítez, Rafael",3,Away
4061,2006-03-25,2005.0,Liverpool,Everton,3-1,3,1,1,1,4,2,H,"Benítez, Rafael",3,Anfield
4062,2006-04-01,2005.0,West Bromwich Albion,Liverpool,0-2,0,2,1,1,2,-2,A,"Benítez, Rafael",2,Away
4063,2006-04-09,2005.0,Liverpool,Bolton Wanderers,1-0,1,0,1,1,1,1,H,"Benítez, Rafael",1,Anfield
4064,2006-04-16,2005.0,Blackburn Rovers,Liverpool,0-1,0,1,1,1,1,-1,A,"Benítez, Rafael",1,Away
4065,2006-04-26,2005.0,West Ham United,Liverpool,1-2,1,2,1,1,3,-1,A,"Benítez, Rafael",2,Away
4066,2006-04-29,2005.0,Liverpool,Aston Villa,3-1,3,1,1,1,4,2,H,"Benítez, Rafael",3,Anfield
4067,2006-05-07,2005.0,Portsmouth,Liverpool,1-3,1,3,1,1,4,-2,A,"Benítez, Rafael",3,Away
4068,2006-08-19,2006.0,Sheffield United,Liverpool,1-1,1,1,1,1,2,0,D,"Benítez, Rafael",1,Away
4069,2006-08-26,2006.0,Liverpool,West Ham United,2-1,2,1,1,1,3,1,H,"Benítez, Rafael",2,Anfield
4070,2006-09-09,2006.0,Everton,Liverpool,3-0,3,0,1,1,3,3,H,"Benítez, Rafael",0,Away
4071,2006-09-17,2006.0,Chelsea,Liverpool,1-0,1,0,1,1,1,1,H,"Benítez, Rafael",0,Away
4072,2006-09-20,2006.0,Liverpool,Newcastle United,2-0,2,0,1,1,2,2,H,"Benítez, Rafael",2,Anfield
4073,2006-09-23,2006.0,Liverpool,Tottenham Hotspur,3-0,3,0,1,1,3,3,H,"Benítez, Rafael",3,Anfield
4074,2006-09-30,2006.0,Bolton Wanderers,Liverpool,2-0,2,0,1,1,2,2,H,"Benítez, Rafael",0,Away
4075,2006-10-14,2006.0,Liverpool,Blackburn Rovers,1-1,1,1,1,1,2,0,D,"Benítez, Rafael",1,Anfield
4076,2006-10-22,2006.0,Manchester United,Liverpool,2-0,2,0,1,1,2,2,H,"Benítez, Rafael",0,Away
4077,2006-10-28,2006.0,Liverpool,Aston Villa,3-1,3,1,1,1,4,2,H,"Benítez, Rafael",3,Anfield
4078,2006-11-04,2006.0,Liverpool,Reading,2-0,2,0,1,1,2,2,H,"Benítez, Rafael",2,Anfield
4079,2006-11-12,2006.0,Arsenal,Liverpool,3-0,3,0,1,1,3,3,H,"Benítez, Rafael",0,Away
4080,2006-11-18,2006.0,Middlesbrough,Liverpool,0-0,0,0,1,1,0,0,D,"Benítez, Rafael",0,Away
4081,2006-11-25,2006.0,Liverpool,Manchester City,1-0,1,0,1,1,1,1,H,"Benítez, Rafael",1,Anfield
4082,2006-11-29,2006.0,Liverpool,Portsmouth,0-0,0,0,1,1,0,0,D,"Benítez, Rafael",0,Anfield
4083,2006-12-02,2006.0,Wigan Athletic,Liverpool,0-4,0,4,1,1,4,-4,A,"Benítez, Rafael",4,Away
4084,2006-12-09,2006.0,Liverpool,Fulham,4-0,4,0,1,1,4,4,H,"Benítez, Rafael",4,Anfield
4085,2006-12-16,2006.0,Charlton Athletic,Liverpool,0-3,0,3,1,1,3,-3,A,"Benítez, Rafael",3,Away
4086,2006-12-23,2006.0,Liverpool,Watford,2-0,2,0,1,1,2,2,H,"Benítez, Rafael",2,Anfield
4087,2006-12-26,2006.0,Blackburn Rovers,Liverpool,1-0,1,0,1,1,1,1,H,"Benítez, Rafael",0,Away
4088,2006-12-30,2006.0,Tottenham Hotspur,Liverpool,0-1,0,1,1,1,1,-1,A,"Benítez, Rafael",1,Away
4089,2007-01-01,2006.0,Liverpool,Bolton Wanderers,3-0,3,0,1,1,3,3,H,"Benítez, Rafael",3,Anfield
4090,2007-01-13,2006.0,Watford,Liverpool,0-3,0,3,1,1,3,-3,A,"Benítez, Rafael",3,Away
4091,2007-01-20,2006.0,Liverpool,Chelsea,2-0,2,0,1,1,2,2,H,"Benítez, Rafael",2,Anfield
4092,2007-01-30,2006.0,West Ham United,Liverpool,1-2,1,2,1,1,3,-1,A,"Benítez, Rafael",2,Away
4093,2007-02-03,2006.0,Liverpool,Everton,0-0,0,0,1,1,0,0,D,"Benítez, Rafael",0,Anfield
4094,2007-02-10,2006.0,Newcastle United,Liverpool,2-1,2,1,1,1,3,1,H,"Benítez, Rafael",1,Away
4095,2007-02-24,2006.0,Liverpool,Sheffield United,4-0,4,0,1,1,4,4,H,"Benítez, Rafael",4,Anfield
4096,2007-03-03,2006.0,Liverpool,Manchester United,0-1,0,1,1,1,1,-1,A,"Benítez, Rafael",0,Anfield
4097,2007-03-18,2006.0,Aston Villa,Liverpool,0-0,0,0,1,1,0,0,D,"Benítez, Rafael",0,Away
4098,2007-03-31,2006.0,Liverpool,Arsenal,4-1,4,1,1,1,5,3,H,"Benítez, Rafael",4,Anfield
4099,2007-04-07,2006.0,Reading,Liverpool,1-2,1,2,1,1,3,-1,A,"Benítez, Rafael",2,Away
4100,2007-04-14,2006.0,Manchester City,Liverpool,0-0,0,0,1,1,0,0,D,"Benítez, Rafael",0,Away
4101,2007-04-18,2006.0,Liverpool,Middlesbrough,2-0,2,0,1,1,2,2,H,"Benítez, Rafael",2,Anfield
4102,2007-04-21,2006.0,Liverpool,Wigan Athletic,2-0,2,0,1,1,2,2,H,"Benítez, Rafael",2,Anfield
4103,2007-04-28,2006.0,Portsmouth,Liverpool,2-1,2,1,1,1,3,1,H,"Benítez, Rafael",1,Away
4104,2007-05-05,2006.0,Fulham,Liverpool,1-0,1,0,1,1,1,1,H,"Benítez, Rafael",0,Away
4105,2007-05-13,2006.0,Liverpool,Charlton Athletic,2-2,2,2,1,1,4,0,D,"Benítez, Rafael",2,Anfield
4106,2007-08-11,2007.0,Aston Villa,Liverpool,1-2,1,2,1,1,3,-1,A,"Benítez, Rafael",2,Away
4107,2007-08-19,2007.0,Liverpool,Chelsea,1-1,1,1,1,1,2,0,D,"Benítez, Rafael",1,Anfield
4108,2007-08-25,2007.0,Sunderland,Liverpool,0-2,0,2,1,1,2,-2,A,"Benítez, Rafael",2,Away
4109,2007-09-01,2007.0,Liverpool,Derby County,6-0,6,0,1,1,6,6,H,"Benítez, Rafael",6,Anfield
4110,2007-09-15,2007.0,Portsmouth,Liverpool,0-0,0,0,1,1,0,0,D,"Benítez, Rafael",0,Away
4111,2007-09-22,2007.0,Liverpool,Birmingham City,0-0,0,0,1,1,0,0,D,"Benítez, Rafael",0,Anfield
4112,2007-09-29,2007.0,Wigan Athletic,Liverpool,0-1,0,1,1,1,1,-1,A,"Benítez, Rafael",1,Away
4113,2007-10-07,2007.0,Liverpool,Tottenham Hotspur,2-2,2,2,1,1,4,0,D,"Benítez, Rafael",2,Anfield
4114,2007-10-20,2007.0,Everton,Liverpool,1-2,1,2,1,1,3,-1,A,"Benítez, Rafael",2,Away
4115,2007-10-28,2007.0,Liverpool,Arsenal,1-1,1,1,1,1,2,0,D,"Benítez, Rafael",1,Anfield
4116,2007-11-03,2007.0,Blackburn Rovers,Liverpool,0-0,0,0,1,1,0,0,D,"Benítez, Rafael",0,Away
4117,2007-11-10,2007.0,Liverpool,Fulham,2-0,2,0,1,1,2,2,H,"Benítez, Rafael",2,Anfield
4118,2007-11-24,2007.0,Newcastle United,Liverpool,0-3,0,3,1,1,3,-3,A,"Benítez, Rafael",3,Away
4119,2007-12-02,2007.0,Liverpool,Bolton Wanderers,4-0,4,0,1,1,4,4,H,"Benítez, Rafael",4,Anfield
4120,2007-12-08,2007.0,Reading,Liverpool,3-1,3,1,1,1,4,2,H,"Benítez, Rafael",1,Away
4121,2007-12-16,2007.0,Liverpool,Manchester United,0-1,0,1,1,1,1,-1,A,"Benítez, Rafael",0,Anfield
4122,2007-12-22,2007.0,Liverpool,Portsmouth,4-1,4,1,1,1,5,3,H,"Benítez, Rafael",4,Anfield
4123,2007-12-26,2007.0,Derby County,Liverpool,1-2,1,2,1,1,3,-1,A,"Benítez, Rafael",2,Away
4124,2007-12-30,2007.0,Manchester City,Liverpool,0-0,0,0,1,1,0,0,D,"Benítez, Rafael",0,Away
4125,2008-01-02,2007.0,Liverpool,Wigan Athletic,1-1,1,1,1,1,2,0,D,"Benítez, Rafael",1,Anfield
4126,2008-01-12,2007.0,Middlesbrough,Liverpool,1-1,1,1,1,1,2,0,D,"Benítez, Rafael",1,Away
4127,2008-01-21,2007.0,Liverpool,Aston Villa,2-2,2,2,1,1,4,0,D,"Benítez, Rafael",2,Anfield
4128,2008-01-30,2007.0,West Ham United,Liverpool,1-0,1,0,1,1,1,1,H,"Benítez, Rafael",0,Away
4129,2008-02-02,2007.0,Liverpool,Sunderland,3-0,3,0,1,1,3,3,H,"Benítez, Rafael",3,Anfield
4130,2008-02-10,2007.0,Chelsea,Liverpool,0-0,0,0,1,1,0,0,D,"Benítez, Rafael",0,Away
4131,2008-02-23,2007.0,Liverpool,Middlesbrough,3-2,3,2,1,1,5,1,H,"Benítez, Rafael",3,Anfield
4132,2008-03-02,2007.0,Bolton Wanderers,Liverpool,1-3,1,3,1,1,4,-2,A,"Benítez, Rafael",3,Away
4133,2008-03-05,2007.0,Liverpool,West Ham United,4-0,4,0,1,1,4,4,H,"Benítez, Rafael",4,Anfield
4134,2008-03-08,2007.0,Liverpool,Newcastle United,3-0,3,0,1,1,3,3,H,"Benítez, Rafael",3,Anfield
4135,2008-03-15,2007.0,Liverpool,Reading,2-1,2,1,1,1,3,1,H,"Benítez, Rafael",2,Anfield
4136,2008-03-23,2007.0,Manchester United,Liverpool,3-0,3,0,1,1,3,3,H,"Benítez, Rafael",0,Away
4137,2008-03-30,2007.0,Liverpool,Everton,1-0,1,0,1,1,1,1,H,"Benítez, Rafael",1,Anfield
4138,2008-04-05,2007.0,Arsenal,Liverpool,1-1,1,1,1,1,2,0,D,"Benítez, Rafael",1,Away
4139,2008-04-13,2007.0,Liverpool,Blackburn Rovers,3-1,3,1,1,1,4,2,H,"Benítez, Rafael",3,Anfield
4140,2008-04-19,2007.0,Fulham,Liverpool,0-2,0,2,1,1,2,-2,A,"Benítez, Rafael",2,Away
4141,2008-04-26,2007.0,Birmingham City,Liverpool,2-2,2,2,1,1,4,0,D,"Benítez, Rafael",2,Away
4142,2008-05-04,2007.0,Liverpool,Manchester City,1-0,1,0,1,1,1,1,H,"Benítez, Rafael",1,Anfield
4143,2008-05-11,2007.0,Tottenham Hotspur,Liverpool,0-2,0,2,1,1,2,-2,A,"Benítez, Rafael",2,Away
4144,2008-08-16,2008.0,Sunderland,Liverpool,0-1,0,1,1,1,1,-1,A,"Benítez, Rafael",1,Away
4145,2008-08-23,2008.0,Liverpool,Middlesbrough,2-1,2,1,1,1,3,1,H,"Benítez, Rafael",2,Anfield
4146,2008-08-31,2008.0,Aston Villa,Liverpool,0-0,0,0,1,1,0,0,D,"Benítez, Rafael",0,Away
4147,2008-09-13,2008.0,Liverpool,Manchester United,2-1,2,1,1,1,3,1,H,"Benítez, Rafael",2,Anfield
4148,2008-09-20,2008.0,Liverpool,Stoke City,0-0,0,0,1,1,0,0,D,"Benítez, Rafael",0,Anfield
4149,2008-09-27,2008.0,Everton,Liverpool,0-2,0,2,1,1,2,-2,A,"Benítez, Rafael",2,Away
4150,2008-10-05,2008.0,Manchester City,Liverpool,2-3,2,3,1,1,5,-1,A,"Benítez, Rafael",3,Away
4151,2008-10-18,2008.0,Liverpool,Wigan Athletic,3-2,3,2,1,1,5,1,H,"Benítez, Rafael",3,Anfield
4152,2008-10-26,2008.0,Chelsea,Liverpool,0-1,0,1,1,1,1,-1,A,"Benítez, Rafael",1,Away
4153,2008-10-29,2008.0,Liverpool,Portsmouth,1-0,1,0,1,1,1,1,H,"Benítez, Rafael",1,Anfield
4154,2008-11-01,2008.0,Tottenham Hotspur,Liverpool,2-1,2,1,1,1,3,1,H,"Benítez, Rafael",1,Away
4155,2008-11-08,2008.0,Liverpool,West Bromwich Albion,3-0,3,0,1,1,3,3,H,"Benítez, Rafael",3,Anfield
4156,2008-11-15,2008.0,Bolton Wanderers,Liverpool,0-2,0,2,1,1,2,-2,A,"Benítez, Rafael",2,Away
4157,2008-11-22,2008.0,Liverpool,Fulham,0-0,0,0,1,1,0,0,D,"Benítez, Rafael",0,Anfield
4158,2008-12-01,2008.0,Liverpool,West Ham United,0-0,0,0,1,1,0,0,D,"Benítez, Rafael",0,Anfield
4159,2008-12-06,2008.0,Blackburn Rovers,Liverpool,1-3,1,3,1,1,4,-2,A,"Benítez, Rafael",3,Away
4160,2008-12-13,2008.0,Liverpool,Hull City,2-2,2,2,1,1,4,0,D,"Benítez, Rafael",2,Anfield
4161,2008-12-21,2008.0,Arsenal,Liverpool,1-1,1,1,1,1,2,0,D,"Benítez, Rafael",1,Away
4162,2008-12-26,2008.0,Liverpool,Bolton Wanderers,3-0,3,0,1,1,3,3,H,"Benítez, Rafael",3,Anfield
4163,2008-12-28,2008.0,Newcastle United,Liverpool,1-5,1,5,1,1,6,-4,A,"Benítez, Rafael",5,Away
4164,2009-01-10,2008.0,Stoke City,Liverpool,0-0,0,0,1,1,0,0,D,"Benítez, Rafael",0,Away
4165,2009-01-19,2008.0,Liverpool,Everton,1-1,1,1,1,1,2,0,D,"Benítez, Rafael",1,Anfield
4166,2009-01-28,2008.0,Wigan Athletic,Liverpool,1-1,1,1,1,1,2,0,D,"Benítez, Rafael",1,Away
4167,2009-02-01,2008.0,Liverpool,Chelsea,2-0,2,0,1,1,2,2,H,"Benítez, Rafael",2,Anfield
4168,2009-02-07,2008.0,Portsmouth,Liverpool,2-3,2,3,1,1,5,-1,A,"Benítez, Rafael",3,Away
4169,2009-02-22,2008.0,Liverpool,Manchester City,1-1,1,1,1,1,2,0,D,"Benítez, Rafael",1,Anfield
4170,2009-02-28,2008.0,Middlesbrough,Liverpool,2-0,2,0,1,1,2,2,H,"Benítez, Rafael",0,Away
4171,2009-03-03,2008.0,Liverpool,Sunderland,2-0,2,0,1,1,2,2,H,"Benítez, Rafael",2,Anfield
4172,2009-03-14,2008.0,Manchester United,Liverpool,1-4,1,4,1,1,5,-3,A,"Benítez, Rafael",4,Away
4173,2009-03-22,2008.0,Liverpool,Aston Villa,5-0,5,0,1,1,5,5,H,"Benítez, Rafael",5,Anfield
4174,2009-04-04,2008.0,Fulham,Liverpool,0-1,0,1,1,1,1,-1,A,"Benítez, Rafael",1,Away
4175,2009-04-11,2008.0,Liverpool,Blackburn Rovers,4-0,4,0,1,1,4,4,H,"Benítez, Rafael",4,Anfield
4176,2009-04-21,2008.0,Liverpool,Arsenal,4-4,4,4,1,1,8,0,D,"Benítez, Rafael",4,Anfield
4177,2009-04-25,2008.0,Hull City,Liverpool,1-3,1,3,1,1,4,-2,A,"Benítez, Rafael",3,Away
4178,2009-05-03,2008.0,Liverpool,Newcastle United,3-0,3,0,1,1,3,3,H,"Benítez, Rafael",3,Anfield
4179,2009-05-09,2008.0,West Ham United,Liverpool,0-3,0,3,1,1,3,-3,A,"Benítez, Rafael",3,Away
4180,2009-05-17,2008.0,West Bromwich Albion,Liverpool,0-2,0,2,1,1,2,-2,A,"Benítez, Rafael",2,Away
4181,2009-05-24,2008.0,Liverpool,Tottenham Hotspur,3-1,3,1,1,1,4,2,H,"Benítez, Rafael",3,Anfield
4182,2009-08-16,2009.0,Tottenham Hotspur,Liverpool,2-1,2,1,1,1,3,1,H,"Benítez, Rafael",1,Away
4183,2009-08-19,2009.0,Liverpool,Stoke City,4-0,4,0,1,1,4,4,H,"Benítez, Rafael",4,Anfield
4184,2009-08-24,2009.0,Liverpool,Aston Villa,1-3,1,3,1,1,4,-2,A,"Benítez, Rafael",1,Anfield
4185,2009-08-29,2009.0,Bolton Wanderers,Liverpool,2-3,2,3,1,1,5,-1,A,"Benítez, Rafael",3,Away
4186,2009-09-12,2009.0,Liverpool,Burnley,4-0,4,0,1,1,4,4,H,"Benítez, Rafael",4,Anfield
4187,2009-09-19,2009.0,West Ham United,Liverpool,2-3,2,3,1,1,5,-1,A,"Benítez, Rafael",3,Away
4188,2009-09-26,2009.0,Liverpool,Hull City,6-1,6,1,1,1,7,5,H,"Benítez, Rafael",6,Anfield
4189,2009-10-04,2009.0,Chelsea,Liverpool,2-0,2,0,1,1,2,2,H,"Benítez, Rafael",0,Away
4190,2009-10-17,2009.0,Sunderland,Liverpool,1-0,1,0,1,1,1,1,H,"Benítez, Rafael",0,Away
4191,2009-10-25,2009.0,Liverpool,Manchester United,2-0,2,0,1,1,2,2,H,"Benítez, Rafael",2,Anfield
4192,2009-10-31,2009.0,Fulham,Liverpool,3-1,3,1,1,1,4,2,H,"Benítez, Rafael",1,Away
4193,2009-11-09,2009.0,Liverpool,Birmingham City,2-2,2,2,1,1,4,0,D,"Benítez, Rafael",2,Anfield
4194,2009-11-21,2009.0,Liverpool,Manchester City,2-2,2,2,1,1,4,0,D,"Benítez, Rafael",2,Anfield
4195,2009-11-29,2009.0,Everton,Liverpool,0-2,0,2,1,1,2,-2,A,"Benítez, Rafael",2,Away
4196,2009-12-05,2009.0,Blackburn Rovers,Liverpool,0-0,0,0,1,1,0,0,D,"Benítez, Rafael",0,Away
4197,2009-12-13,2009.0,Liverpool,Arsenal,1-2,1,2,1,1,3,-1,A,"Benítez, Rafael",1,Anfield
4198,2009-12-16,2009.0,Liverpool,Wigan Athletic,2-1,2,1,1,1,3,1,H,"Benítez, Rafael",2,Anfield
4199,2009-12-19,2009.0,Portsmouth,Liverpool,2-0,2,0,1,1,2,2,H,"Benítez, Rafael",0,Away
4200,2009-12-26,2009.0,Liverpool,Wolverhampton Wanderers,2-0,2,0,1,1,2,2,H,"Benítez, Rafael",2,Anfield
4201,2009-12-29,2009.0,Aston Villa,Liverpool,0-1,0,1,1,1,1,-1,A,"Benítez, Rafael",1,Away
4202,2010-01-16,2009.0,Stoke City,Liverpool,1-1,1,1,1,1,2,0,D,"Benítez, Rafael",1,Away
4203,2010-01-20,2009.0,Liverpool,Tottenham Hotspur,2-0,2,0,1,1,2,2,H,"Benítez, Rafael",2,Anfield
4204,2010-01-26,2009.0,Wolverhampton Wanderers,Liverpool,0-0,0,0,1,1,0,0,D,"Benítez, Rafael",0,Away
4205,2010-01-30,2009.0,Liverpool,Bolton Wanderers,2-0,2,0,1,1,2,2,H,"Benítez, Rafael",2,Anfield
4206,2010-02-06,2009.0,Liverpool,Everton,1-0,1,0,1,1,1,1,H,"Benítez, Rafael",1,Anfield
4207,2010-02-10,2009.0,Arsenal,Liverpool,1-0,1,0,1,1,1,1,H,"Benítez, Rafael",0,Away
4208,2010-02-21,2009.0,Manchester City,Liverpool,0-0,0,0,1,1,0,0,D,"Benítez, Rafael",0,Away
4209,2010-02-28,2009.0,Liverpool,Blackburn Rovers,2-1,2,1,1,1,3,1,H,"Benítez, Rafael",2,Anfield
4210,2010-03-08,2009.0,Wigan Athletic,Liverpool,1-0,1,0,1,1,1,1,H,"Benítez, Rafael",0,Away
4211,2010-03-15,2009.0,Liverpool,Portsmouth,4-1,4,1,1,1,5,3,H,"Benítez, Rafael",4,Anfield
4212,2010-03-21,2009.0,Manchester United,Liverpool,2-1,2,1,1,1,3,1,H,"Benítez, Rafael",1,Away
4213,2010-03-28,2009.0,Liverpool,Sunderland,3-0,3,0,1,1,3,3,H,"Benítez, Rafael",3,Anfield
4214,2010-04-04,2009.0,Birmingham City,Liverpool,1-1,1,1,1,1,2,0,D,"Benítez, Rafael",1,Away
4215,2010-04-11,2009.0,Liverpool,Fulham,0-0,0,0,1,1,0,0,D,"Benítez, Rafael",0,Anfield
4216,2010-04-19,2009.0,Liverpool,West Ham United,3-0,3,0,1,1,3,3,H,"Benítez, Rafael",3,Anfield
4217,2010-04-25,2009.0,Burnley,Liverpool,0-4,0,4,1,1,4,-4,A,"Benítez, Rafael",4,Away
4218,2010-05-02,2009.0,Liverpool,Chelsea,0-2,0,2,1,1,2,-2,A,"Benítez, Rafael",0,Anfield
4219,2010-05-09,2009.0,Hull City,Liverpool,0-0,0,0,1,1,0,0,D,"Benítez, Rafael",0,Away
4220,2010-08-15,2010.0,Liverpool,Arsenal,1-1,1,1,1,1,2,0,D,"Hodgson, Roy",1,Anfield
4221,2010-08-23,2010.0,Manchester City,Liverpool,3-0,3,0,1,1,3,3,H,"Hodgson, Roy",0,Away
4222,2010-08-29,2010.0,Liverpool,West Bromwich Albion,1-0,1,0,1,1,1,1,H,"Hodgson, Roy",1,Anfield
4223,2010-09-12,2010.0,Birmingham City,Liverpool,0-0,0,0,1,1,0,0,D,"Hodgson, Roy",0,Away
4224,2010-09-19,2010.0,Manchester United,Liverpool,3-2,3,2,1,1,5,1,H,"Hodgson, Roy",2,Away
4225,2010-09-25,2010.0,Liverpool,Sunderland,2-2,2,2,1,1,4,0,D,"Hodgson, Roy",2,Anfield
4226,2010-10-03,2010.0,Liverpool,Blackpool,1-2,1,2,1,1,3,-1,A,"Hodgson, Roy",1,Anfield
4227,2010-10-17,2010.0,Everton,Liverpool,2-0,2,0,1,1,2,2,H,"Hodgson, Roy",0,Away
4228,2010-10-24,2010.0,Liverpool,Blackburn Rovers,2-1,2,1,1,1,3,1,H,"Hodgson, Roy",2,Anfield
4229,2010-10-31,2010.0,Bolton Wanderers,Liverpool,0-1,0,1,1,1,1,-1,A,"Hodgson, Roy",1,Away
4230,2010-11-07,2010.0,Liverpool,Chelsea,2-0,2,0,1,1,2,2,H,"Hodgson, Roy",2,Anfield
4231,2010-11-10,2010.0,Wigan Athletic,Liverpool,1-1,1,1,1,1,2,0,D,"Hodgson, Roy",1,Away
4232,2010-11-13,2010.0,Stoke City,Liverpool,2-0,2,0,1,1,2,2,H,"Hodgson, Roy",0,Away
4233,2010-11-20,2010.0,Liverpool,West Ham United,3-0,3,0,1,1,3,3,H,"Hodgson, Roy",3,Anfield
4234,2010-11-28,2010.0,Tottenham Hotspur,Liverpool,2-1,2,1,1,1,3,1,H,"Hodgson, Roy",1,Away
4235,2010-12-06,2010.0,Liverpool,Aston Villa,3-0,3,0,1,1,3,3,H,"Hodgson, Roy",3,Anfield
4236,2010-12-11,2010.0,Newcastle United,Liverpool,3-1,3,1,1,1,4,2,H,"Hodgson, Roy",1,Away
4237,2010-12-29,2010.0,Liverpool,Wolverhampton Wanderers,0-1,0,1,1,1,1,-1,A,"Hodgson, Roy",0,Anfield
4238,2011-01-01,2010.0,Liverpool,Bolton Wanderers,2-1,2,1,1,1,3,1,H,"Hodgson, Roy",2,Anfield
4239,2011-01-05,2010.0,Blackburn Rovers,Liverpool,3-1,3,1,1,1,4,2,H,"Hodgson, Roy",1,Away
4240,2011-01-12,2010.0,Blackpool,Liverpool,2-1,2,1,1,1,3,1,H,"Dalglish, Kenny",1,Away
4241,2011-01-16,2010.0,Liverpool,Everton,2-2,2,2,1,1,4,0,D,"Dalglish, Kenny",2,Anfield
4242,2011-01-22,2010.0,Wolverhampton Wanderers,Liverpool,0-3,0,3,1,1,3,-3,A,"Dalglish, Kenny",3,Away
4243,2011-01-26,2010.0,Liverpool,Fulham,1-0,1,0,1,1,1,1,H,"Dalglish, Kenny",1,Anfield
4244,2011-02-02,2010.0,Liverpool,Stoke City,2-0,2,0,1,1,2,2,H,"Dalglish, Kenny",2,Anfield
4245,2011-02-06,2010.0,Chelsea,Liverpool,0-1,0,1,1,1,1,-1,A,"Dalglish, Kenny",1,Away
4246,2011-02-12,2010.0,Liverpool,Wigan Athletic,1-1,1,1,1,1,2,0,D,"Dalglish, Kenny",1,Anfield
4247,2011-02-27,2010.0,West Ham United,Liverpool,3-1,3,1,1,1,4,2,H,"Dalglish, Kenny",1,Away
4248,2011-03-06,2010.0,Liverpool,Manchester United,3-1,3,1,1,1,4,2,H,"Dalglish, Kenny",3,Anfield
4249,2011-03-20,2010.0,Sunderland,Liverpool,0-2,0,2,1,1,2,-2,A,"Dalglish, Kenny",2,Away
4250,2011-04-02,2010.0,West Bromwich Albion,Liverpool,2-1,2,1,1,1,3,1,H,"Dalglish, Kenny",1,Away
4251,2011-04-11,2010.0,Liverpool,Manchester City,3-0,3,0,1,1,3,3,H,"Dalglish, Kenny",3,Anfield
4252,2011-04-17,2010.0,Arsenal,Liverpool,1-1,1,1,1,1,2,0,D,"Dalglish, Kenny",1,Away
4253,2011-04-23,2010.0,Liverpool,Birmingham City,5-0,5,0,1,1,5,5,H,"Dalglish, Kenny",5,Anfield
4254,2011-05-01,2010.0,Liverpool,Newcastle United,3-0,3,0,1,1,3,3,H,"Dalglish, Kenny",3,Anfield
4255,2011-05-09,2010.0,Fulham,Liverpool,2-5,2,5,1,1,7,-3,A,"Dalglish, Kenny",5,Away
4256,2011-05-15,2010.0,Liverpool,Tottenham Hotspur,0-2,0,2,1,1,2,-2,A,"Dalglish, Kenny",0,Anfield
4257,2011-05-22,2010.0,Aston Villa,Liverpool,1-0,1,0,1,1,1,1,H,"Dalglish, Kenny",0,Away
4258,2011-08-13,2011.0,Liverpool,Sunderland,1-1,1,1,1,1,2,0,D,"Dalglish, Kenny",1,Anfield
4259,2011-08-20,2011.0,Arsenal,Liverpool,0-2,0,2,1,1,2,-2,A,"Dalglish, Kenny",2,Away
4260,2011-08-27,2011.0,Liverpool,Bolton Wanderers,3-1,3,1,1,1,4,2,H,"Dalglish, Kenny",3,Anfield
4261,2011-09-10,2011.0,Stoke City,Liverpool,1-0,1,0,1,1,1,1,H,"Dalglish, Kenny",0,Away
4262,2011-09-18,2011.0,Tottenham Hotspur,Liverpool,4-0,4,0,1,1,4,4,H,"Dalglish, Kenny",0,Away
4263,2011-09-24,2011.0,Liverpool,Wolverhampton Wanderers,2-1,2,1,1,1,3,1,H,"Dalglish, Kenny",2,Anfield
4264,2011-10-01,2011.0,Everton,Liverpool,0-2,0,2,1,1,2,-2,A,"Dalglish, Kenny",2,Away
4265,2011-10-15,2011.0,Liverpool,Manchester United,1-1,1,1,1,1,2,0,D,"Dalglish, Kenny",1,Anfield
4266,2011-10-22,2011.0,Liverpool,Norwich City,1-1,1,1,1,1,2,0,D,"Dalglish, Kenny",1,Anfield
4267,2011-10-29,2011.0,West Bromwich Albion,Liverpool,0-2,0,2,1,1,2,-2,A,"Dalglish, Kenny",2,Away
4268,2011-11-05,2011.0,Liverpool,Swansea City,0-0,0,0,1,1,0,0,D,"Dalglish, Kenny",0,Anfield
4269,2011-11-20,2011.0,Chelsea,Liverpool,1-2,1,2,1,1,3,-1,A,"Dalglish, Kenny",2,Away
4270,2011-11-27,2011.0,Liverpool,Manchester City,1-1,1,1,1,1,2,0,D,"Dalglish, Kenny",1,Anfield
4271,2011-12-05,2011.0,Fulham,Liverpool,1-0,1,0,1,1,1,1,H,"Dalglish, Kenny",0,Away
4272,2011-12-10,2011.0,Liverpool,Queens Park Rangers,1-0,1,0,1,1,1,1,H,"Dalglish, Kenny",1,Anfield
4273,2011-12-18,2011.0,Aston Villa,Liverpool,0-2,0,2,1,1,2,-2,A,"Dalglish, Kenny",2,Away
4274,2011-12-21,2011.0,Wigan Athletic,Liverpool,0-0,0,0,1,1,0,0,D,"Dalglish, Kenny",0,Away
4275,2011-12-26,2011.0,Liverpool,Blackburn Rovers,1-1,1,1,1,1,2,0,D,"Dalglish, Kenny",1,Anfield
4276,2011-12-30,2011.0,Liverpool,Newcastle United,3-1,3,1,1,1,4,2,H,"Dalglish, Kenny",3,Anfield
4277,2012-01-03,2011.0,Manchester City,Liverpool,3-0,3,0,1,1,3,3,H,"Dalglish, Kenny",0,Away
4278,2012-01-14,2011.0,Liverpool,Stoke City,0-0,0,0,1,1,0,0,D,"Dalglish, Kenny",0,Anfield
4279,2012-01-21,2011.0,Bolton Wanderers,Liverpool,3-1,3,1,1,1,4,2,H,"Dalglish, Kenny",1,Away
4280,2012-01-31,2011.0,Wolverhampton Wanderers,Liverpool,0-3,0,3,1,1,3,-3,A,"Dalglish, Kenny",3,Away
4281,2012-02-06,2011.0,Liverpool,Tottenham Hotspur,0-0,0,0,1,1,0,0,D,"Dalglish, Kenny",0,Anfield
4282,2012-02-11,2011.0,Manchester United,Liverpool,2-1,2,1,1,1,3,1,H,"Dalglish, Kenny",1,Away
4283,2012-03-03,2011.0,Liverpool,Arsenal,1-2,1,2,1,1,3,-1,A,"Dalglish, Kenny",1,Anfield
4284,2012-03-10,2011.0,Sunderland,Liverpool,1-0,1,0,1,1,1,1,H,"Dalglish, Kenny",0,Away
4285,2012-03-13,2011.0,Liverpool,Everton,3-0,3,0,1,1,3,3,H,"Dalglish, Kenny",3,Anfield
4286,2012-03-21,2011.0,Queens Park Rangers,Liverpool,3-2,3,2,1,1,5,1,H,"Dalglish, Kenny",2,Away
4287,2012-03-24,2011.0,Liverpool,Wigan Athletic,1-2,1,2,1,1,3,-1,A,"Dalglish, Kenny",1,Anfield
4288,2012-04-01,2011.0,Newcastle United,Liverpool,2-0,2,0,1,1,2,2,H,"Dalglish, Kenny",0,Away
4289,2012-04-07,2011.0,Liverpool,Aston Villa,1-1,1,1,1,1,2,0,D,"Dalglish, Kenny",1,Anfield
4290,2012-04-10,2011.0,Blackburn Rovers,Liverpool,2-3,2,3,1,1,5,-1,A,"Dalglish, Kenny",3,Away
4291,2012-04-22,2011.0,Liverpool,West Bromwich Albion,0-1,0,1,1,1,1,-1,A,"Dalglish, Kenny",0,Anfield
4292,2012-04-28,2011.0,Norwich City,Liverpool,0-3,0,3,1,1,3,-3,A,"Dalglish, Kenny",3,Away
4293,2012-05-01,2011.0,Liverpool,Fulham,0-1,0,1,1,1,1,-1,A,"Dalglish, Kenny",0,Anfield
4294,2012-05-08,2011.0,Liverpool,Chelsea,4-1,4,1,1,1,5,3,H,"Dalglish, Kenny",4,Anfield
4295,2012-05-13,2011.0,Swansea City,Liverpool,1-0,1,0,1,1,1,1,H,"Dalglish, Kenny",0,Away
4296,2012-08-18,2012.0,West Bromwich Albion,Liverpool,3-0,3,0,1,1,3,3,H,"Rodgers, Brendan",0,Away
4297,2012-08-26,2012.0,Liverpool,Manchester City,2-2,2,2,1,1,4,0,D,"Rodgers, Brendan",2,Anfield
4298,2012-09-02,2012.0,Liverpool,Arsenal,0-2,0,2,1,1,2,-2,A,"Rodgers, Brendan",0,Anfield
4299,2012-09-15,2012.0,Sunderland,Liverpool,1-1,1,1,1,1,2,0,D,"Rodgers, Brendan",1,Away
4300,2012-09-23,2012.0,Liverpool,Manchester United,1-2,1,2,1,1,3,-1,A,"Rodgers, Brendan",1,Anfield
4301,2012-09-29,2012.0,Norwich City,Liverpool,2-5,2,5,1,1,7,-3,A,"Rodgers, Brendan",5,Away
4302,2012-10-07,2012.0,Liverpool,Stoke City,0-0,0,0,1,1,0,0,D,"Rodgers, Brendan",0,Anfield
4303,2012-10-20,2012.0,Liverpool,Reading,1-0,1,0,1,1,1,1,H,"Rodgers, Brendan",1,Anfield
4304,2012-10-28,2012.0,Everton,Liverpool,2-2,2,2,1,1,4,0,D,"Rodgers, Brendan",2,Away
4305,2012-11-04,2012.0,Liverpool,Newcastle United,1-1,1,1,1,1,2,0,D,"Rodgers, Brendan",1,Anfield
4306,2012-11-11,2012.0,Chelsea,Liverpool,1-1,1,1,1,1,2,0,D,"Rodgers, Brendan",1,Away
4307,2012-11-17,2012.0,Liverpool,Wigan Athletic,3-0,3,0,1,1,3,3,H,"Rodgers, Brendan",3,Anfield
4308,2012-11-25,2012.0,Swansea City,Liverpool,0-0,0,0,1,1,0,0,D,"Rodgers, Brendan",0,Away
4309,2012-11-28,2012.0,Tottenham Hotspur,Liverpool,2-1,2,1,1,1,3,1,H,"Rodgers, Brendan",1,Away
4310,2012-12-01,2012.0,Liverpool,Southampton,1-0,1,0,1,1,1,1,H,"Rodgers, Brendan",1,Anfield
4311,2012-12-09,2012.0,West Ham United,Liverpool,2-3,2,3,1,1,5,-1,A,"Rodgers, Brendan",3,Away
4312,2012-12-15,2012.0,Liverpool,Aston Villa,1-3,1,3,1,1,4,-2,A,"Rodgers, Brendan",1,Anfield
4313,2012-12-22,2012.0,Liverpool,Fulham,4-0,4,0,1,1,4,4,H,"Rodgers, Brendan",4,Anfield
4314,2012-12-26,2012.0,Stoke City,Liverpool,3-1,3,1,1,1,4,2,H,"Rodgers, Brendan",1,Away
4315,2012-12-30,2012.0,Queens Park Rangers,Liverpool,0-3,0,3,1,1,3,-3,A,"Rodgers, Brendan",3,Away
4316,2013-01-02,2012.0,Liverpool,Sunderland,3-0,3,0,1,1,3,3,H,"Rodgers, Brendan",3,Anfield
4317,2013-01-13,2012.0,Manchester United,Liverpool,2-1,2,1,1,1,3,1,H,"Rodgers, Brendan",1,Away
4318,2013-01-19,2012.0,Liverpool,Norwich City,5-0,5,0,1,1,5,5,H,"Rodgers, Brendan",5,Anfield
4319,2013-01-30,2012.0,Arsenal,Liverpool,2-2,2,2,1,1,4,0,D,"Rodgers, Brendan",2,Away
4320,2013-02-03,2012.0,Manchester City,Liverpool,2-2,2,2,1,1,4,0,D,"Rodgers, Brendan",2,Away
4321,2013-02-11,2012.0,Liverpool,West Bromwich Albion,0-2,0,2,1,1,2,-2,A,"Rodgers, Brendan",0,Anfield
4322,2013-02-17,2012.0,Liverpool,Swansea City,5-0,5,0,1,1,5,5,H,"Rodgers, Brendan",5,Anfield
4323,2013-03-02,2012.0,Wigan Athletic,Liverpool,0-4,0,4,1,1,4,-4,A,"Rodgers, Brendan",4,Away
4324,2013-03-10,2012.0,Liverpool,Tottenham Hotspur,3-2,3,2,1,1,5,1,H,"Rodgers, Brendan",3,Anfield
4325,2013-03-16,2012.0,Southampton,Liverpool,3-1,3,1,1,1,4,2,H,"Rodgers, Brendan",1,Away
4326,2013-03-31,2012.0,Aston Villa,Liverpool,1-2,1,2,1,1,3,-1,A,"Rodgers, Brendan",2,Away
4327,2013-04-07,2012.0,Liverpool,West Ham United,0-0,0,0,1,1,0,0,D,"Rodgers, Brendan",0,Anfield
4328,2013-04-13,2012.0,Reading,Liverpool,0-0,0,0,1,1,0,0,D,"Rodgers, Brendan",0,Away
4329,2013-04-21,2012.0,Liverpool,Chelsea,2-2,2,2,1,1,4,0,D,"Rodgers, Brendan",2,Anfield
4330,2013-04-27,2012.0,Newcastle United,Liverpool,0-6,0,6,1,1,6,-6,A,"Rodgers, Brendan",6,Away
4331,2013-05-05,2012.0,Liverpool,Everton,0-0,0,0,1,1,0,0,D,"Rodgers, Brendan",0,Anfield
4332,2013-05-12,2012.0,Fulham,Liverpool,1-3,1,3,1,1,4,-2,A,"Rodgers, Brendan",3,Away
4333,2013-05-19,2012.0,Liverpool,Queens Park Rangers,1-0,1,0,1,1,1,1,H,"Rodgers, Brendan",1,Anfield
4334,2013-08-17,2013.0,Liverpool,Stoke City,1-0,1,0,1,1,1,1,H,"Rodgers, Brendan",1,Anfield
4335,2013-08-24,2013.0,Aston Villa,Liverpool,0-1,0,1,1,1,1,-1,A,"Rodgers, Brendan",1,Away
4336,2013-09-01,2013.0,Liverpool,Manchester United,1-0,1,0,1,1,1,1,H,"Rodgers, Brendan",1,Anfield
4337,2013-09-16,2013.0,Swansea City,Liverpool,2-2,2,2,1,1,4,0,D,"Rodgers, Brendan",2,Away
4338,2013-09-21,2013.0,Liverpool,Southampton,0-1,0,1,1,1,1,-1,A,"Rodgers, Brendan",0,Anfield
4339,2013-09-29,2013.0,Sunderland,Liverpool,1-3,1,3,1,1,4,-2,A,"Rodgers, Brendan",3,Away
4340,2013-10-05,2013.0,Liverpool,Crystal Palace,3-1,3,1,1,1,4,2,H,"Rodgers, Brendan",3,Anfield
4341,2013-10-19,2013.0,Newcastle United,Liverpool,2-2,2,2,1,1,4,0,D,"Rodgers, Brendan",2,Away
4342,2013-10-26,2013.0,Liverpool,West Bromwich Albion,4-1,4,1,1,1,5,3,H,"Rodgers, Brendan",4,Anfield
4343,2013-11-02,2013.0,Arsenal,Liverpool,2-0,2,0,1,1,2,2,H,"Rodgers, Brendan",0,Away
4344,2013-11-09,2013.0,Liverpool,Fulham,4-0,4,0,1,1,4,4,H,"Rodgers, Brendan",4,Anfield
4345,2013-11-23,2013.0,Everton,Liverpool,3-3,3,3,1,1,6,0,D,"Rodgers, Brendan",3,Away
4346,2013-12-01,2013.0,Hull City,Liverpool,3-1,3,1,1,1,4,2,H,"Rodgers, Brendan",1,Away
4347,2013-12-04,2013.0,Liverpool,Norwich City,5-1,5,1,1,1,6,4,H,"Rodgers, Brendan",5,Anfield
4348,2013-12-07,2013.0,Liverpool,West Ham United,4-1,4,1,1,1,5,3,H,"Rodgers, Brendan",4,Anfield
4349,2013-12-15,2013.0,Tottenham Hotspur,Liverpool,0-5,0,5,1,1,5,-5,A,"Rodgers, Brendan",5,Away
4350,2013-12-21,2013.0,Liverpool,Cardiff City,3-1,3,1,1,1,4,2,H,"Rodgers, Brendan",3,Anfield
4351,2013-12-26,2013.0,Manchester City,Liverpool,2-1,2,1,1,1,3,1,H,"Rodgers, Brendan",1,Away
4352,2013-12-29,2013.0,Chelsea,Liverpool,2-1,2,1,1,1,3,1,H,"Rodgers, Brendan",1,Away
4353,2014-01-01,2013.0,Liverpool,Hull City,2-0,2,0,1,1,2,2,H,"Rodgers, Brendan",2,Anfield
4354,2014-01-12,2013.0,Stoke City,Liverpool,3-5,3,5,1,1,8,-2,A,"Rodgers, Brendan",5,Away
4355,2014-01-18,2013.0,Liverpool,Aston Villa,2-2,2,2,1,1,4,0,D,"Rodgers, Brendan",2,Anfield
4356,2014-01-28,2013.0,Liverpool,Everton,4-0,4,0,1,1,4,4,H,"Rodgers, Brendan",4,Anfield
4357,2014-02-02,2013.0,West Bromwich Albion,Liverpool,1-1,1,1,1,1,2,0,D,"Rodgers, Brendan",1,Away
4358,2014-02-08,2013.0,Liverpool,Arsenal,5-1,5,1,1,1,6,4,H,"Rodgers, Brendan",5,Anfield
4359,2014-02-12,2013.0,Fulham,Liverpool,2-3,2,3,1,1,5,-1,A,"Rodgers, Brendan",3,Away
4360,2014-02-23,2013.0,Liverpool,Swansea City,4-3,4,3,1,1,7,1,H,"Rodgers, Brendan",4,Anfield
4361,2014-03-01,2013.0,Southampton,Liverpool,0-3,0,3,1,1,3,-3,A,"Rodgers, Brendan",3,Away
4362,2014-03-16,2013.0,Manchester United,Liverpool,0-3,0,3,1,1,3,-3,A,"Rodgers, Brendan",3,Away
4363,2014-03-22,2013.0,Cardiff City,Liverpool,3-6,3,6,1,1,9,-3,A,"Rodgers, Brendan",6,Away
4364,2014-03-26,2013.0,Liverpool,Sunderland,2-1,2,1,1,1,3,1,H,"Rodgers, Brendan",2,Anfield
4365,2014-03-30,2013.0,Liverpool,Tottenham Hotspur,4-0,4,0,1,1,4,4,H,"Rodgers, Brendan",4,Anfield
4366,2014-04-06,2013.0,West Ham United,Liverpool,1-2,1,2,1,1,3,-1,A,"Rodgers, Brendan",2,Away
4367,2014-04-13,2013.0,Liverpool,Manchester City,3-2,3,2,1,1,5,1,H,"Rodgers, Brendan",3,Anfield
4368,2014-04-20,2013.0,Norwich City,Liverpool,2-3,2,3,1,1,5,-1,A,"Rodgers, Brendan",3,Away
4369,2014-04-27,2013.0,Liverpool,Chelsea,0-2,0,2,1,1,2,-2,A,"Rodgers, Brendan",0,Anfield
4370,2014-05-05,2013.0,Crystal Palace,Liverpool,3-3,3,3,1,1,6,0,D,"Rodgers, Brendan",3,Away
4371,2014-05-11,2013.0,Liverpool,Newcastle United,2-1,2,1,1,1,3,1,H,"Rodgers, Brendan",2,Anfield
4372,2014-08-17,2014.0,Liverpool,Southampton,2-1,2,1,1,1,3,1,H,"Rodgers, Brendan",2,Anfield
4373,2014-08-25,2014.0,Manchester City,Liverpool,3-1,3,1,1,1,4,2,H,"Rodgers, Brendan",1,Away
4374,2014-08-31,2014.0,Tottenham Hotspur,Liverpool,0-3,0,3,1,1,3,-3,A,"Rodgers, Brendan",3,Away
4375,2014-09-13,2014.0,Liverpool,Aston Villa,0-1,0,1,1,1,1,-1,A,"Rodgers, Brendan",0,Anfield
4376,2014-09-20,2014.0,West Ham United,Liverpool,3-1,3,1,1,1,4,2,H,"Rodgers, Brendan",1,Away
4377,2014-09-27,2014.0,Liverpool,Everton,1-1,1,1,1,1,2,0,D,"Rodgers, Brendan",1,Anfield
4378,2014-10-04,2014.0,Liverpool,West Bromwich Albion,2-1,2,1,1,1,3,1,H,"Rodgers, Brendan",2,Anfield
4379,2014-10-19,2014.0,Queens Park Rangers,Liverpool,2-3,2,3,1,1,5,-1,A,"Rodgers, Brendan",3,Away
4380,2014-10-25,2014.0,Liverpool,Hull City,0-0,0,0,1,1,0,0,D,"Rodgers, Brendan",0,Anfield
4381,2014-11-01,2014.0,Newcastle United,Liverpool,1-0,1,0,1,1,1,1,H,"Rodgers, Brendan",0,Away
4382,2014-11-08,2014.0,Liverpool,Chelsea,1-2,1,2,1,1,3,-1,A,"Rodgers, Brendan",1,Anfield
4383,2014-11-23,2014.0,Crystal Palace,Liverpool,3-1,3,1,1,1,4,2,H,"Rodgers, Brendan",1,Away
4384,2014-11-29,2014.0,Liverpool,Stoke City,1-0,1,0,1,1,1,1,H,"Rodgers, Brendan",1,Anfield
4385,2014-12-02,2014.0,Leicester City,Liverpool,1-3,1,3,1,1,4,-2,A,"Rodgers, Brendan",3,Away
4386,2014-12-06,2014.0,Liverpool,Sunderland,0-0,0,0,1,1,0,0,D,"Rodgers, Brendan",0,Anfield
4387,2014-12-14,2014.0,Manchester United,Liverpool,3-0,3,0,1,1,3,3,H,"Rodgers, Brendan",0,Away
4388,2014-12-21,2014.0,Liverpool,Arsenal,2-2,2,2,1,1,4,0,D,"Rodgers, Brendan",2,Anfield
4389,2014-12-26,2014.0,Burnley,Liverpool,0-1,0,1,1,1,1,-1,A,"Rodgers, Brendan",1,Away
4390,2014-12-29,2014.0,Liverpool,Swansea City,4-1,4,1,1,1,5,3,H,"Rodgers, Brendan",4,Anfield
4391,2015-01-01,2014.0,Liverpool,Leicester City,2-2,2,2,1,1,4,0,D,"Rodgers, Brendan",2,Anfield
4392,2015-01-10,2014.0,Sunderland,Liverpool,0-1,0,1,1,1,1,-1,A,"Rodgers, Brendan",1,Away
4393,2015-01-17,2014.0,Aston Villa,Liverpool,0-2,0,2,1,1,2,-2,A,"Rodgers, Brendan",2,Away
4394,2015-01-31,2014.0,Liverpool,West Ham United,2-0,2,0,1,1,2,2,H,"Rodgers, Brendan",2,Anfield
4395,2015-02-07,2014.0,Everton,Liverpool,0-0,0,0,1,1,0,0,D,"Rodgers, Brendan",0,Away
4396,2015-02-10,2014.0,Liverpool,Tottenham Hotspur,3-2,3,2,1,1,5,1,H,"Rodgers, Brendan",3,Anfield
4397,2015-02-22,2014.0,Southampton,Liverpool,0-2,0,2,1,1,2,-2,A,"Rodgers, Brendan",2,Away
4398,2015-03-01,2014.0,Liverpool,Manchester City,2-1,2,1,1,1,3,1,H,"Rodgers, Brendan",2,Anfield
4399,2015-03-04,2014.0,Liverpool,Burnley,2-0,2,0,1,1,2,2,H,"Rodgers, Brendan",2,Anfield
4400,2015-03-16,2014.0,Swansea City,Liverpool,0-1,0,1,1,1,1,-1,A,"Rodgers, Brendan",1,Away
4401,2015-03-22,2014.0,Liverpool,Manchester United,1-2,1,2,1,1,3,-1,A,"Rodgers, Brendan",1,Anfield
4402,2015-04-04,2014.0,Arsenal,Liverpool,4-1,4,1,1,1,5,3,H,"Rodgers, Brendan",1,Away
4403,2015-04-13,2014.0,Liverpool,Newcastle United,2-0,2,0,1,1,2,2,H,"Rodgers, Brendan",2,Anfield
4404,2015-04-25,2014.0,West Bromwich Albion,Liverpool,0-0,0,0,1,1,0,0,D,"Rodgers, Brendan",0,Away
4405,2015-04-28,2014.0,Hull City,Liverpool,1-0,1,0,1,1,1,1,H,"Rodgers, Brendan",0,Away
4406,2015-05-02,2014.0,Liverpool,Queens Park Rangers,2-1,2,1,1,1,3,1,H,"Rodgers, Brendan",2,Anfield
4407,2015-05-10,2014.0,Chelsea,Liverpool,1-1,1,1,1,1,2,0,D,"Rodgers, Brendan",1,Away
4408,2015-05-16,2014.0,Liverpool,Crystal Palace,1-3,1,3,1,1,4,-2,A,"Rodgers, Brendan",1,Anfield
4409,2015-05-24,2014.0,Stoke City,Liverpool,6-1,6,1,1,1,7,5,H,"Rodgers, Brendan",1,Away
4410,2015-08-09,2015.0,Stoke City,Liverpool,0-1,0,1,1,1,1,-1,A,"Rodgers, Brendan",1,Away
4411,2015-08-17,2015.0,Liverpool,AFC Bournemouth,1-0,1,0,1,1,1,1,H,"Rodgers, Brendan",1,Anfield
4412,2015-08-24,2015.0,Arsenal,Liverpool,0-0,0,0,1,1,0,0,D,"Rodgers, Brendan",0,Away
4413,2015-08-29,2015.0,Liverpool,West Ham United,0-3,0,3,1,1,3,-3,A,"Rodgers, Brendan",0,Anfield
4414,2015-09-12,2015.0,Manchester United,Liverpool,3-1,3,1,1,1,4,2,H,"Rodgers, Brendan",1,Away
4415,2015-09-20,2015.0,Liverpool,Norwich City,1-1,1,1,1,1,2,0,D,"Rodgers, Brendan",1,Anfield
4416,2015-09-26,2015.0,Liverpool,Aston Villa,3-2,3,2,1,1,5,1,H,"Rodgers, Brendan",3,Anfield
4417,2015-10-04,2015.0,Everton,Liverpool,1-1,1,1,1,1,2,0,D,"Rodgers, Brendan",1,Away
